geoid,No,Yes,tot,with,without
48201542301,310,337,647,0.521,0.479
48201552601,292,233,525,0.444,0.556
48157673800,492,439,931,0.472,0.528
48157674000,359,384,743,0.517,0.483
48157674100,296,384,680,0.565,0.435
48157674200,230,300,530,0.566,0.434
48167720502,432,428,860,0.498,0.502
48167720501,153,145,298,0.487,0.513
48167721202,236,290,526,0.551,0.449
48167722002,287,225,512,0.439,0.561
48167720301,203,187,390,0.479,0.521
48167720503,439,468,907,0.516,0.484
48201323701,299,284,583,0.487,0.513
48201240702,596,533,1129,0.472,0.528
48201240501,253,185,438,0.422,0.578
48201240701,440,449,889,0.505,0.495
48201240901,182,205,387,0.53,0.47
48157675500,1710,1273,2983,0.427,0.573
48157674400,390,582,972,0.599,0.401
48157671400,433,296,729,0.406,0.594
48157675400,1656,1026,2682,0.383,0.617
48201241103,78,82,160,0.512,0.488
48201450802,288,296,584,0.507,0.493
48201450801,74,81,155,0.523,0.477
48201451002,124,113,237,0.477,0.523
48201454302,233,229,462,0.496,0.504
48201451902,157,137,294,0.466,0.534
48201453602,301,286,587,0.487,0.513
48201453403,84,90,174,0.517,0.483
48201453601,80,73,153,0.477,0.523
48201453501,200,206,406,0.507,0.493
48201453502,173,169,342,0.494,0.506
48245000309,114,93,207,0.449,0.551
48245011700,1270,1057,2327,0.454,0.546
48245011800,962,757,1719,0.44,0.56
48201553401,210,214,424,0.505,0.495
48201553402,316,303,619,0.489,0.511
48201553801,165,141,306,0.461,0.539
48201554903,432,349,781,0.447,0.553
48157674300,299,425,724,0.587,0.413
48157674700,920,757,1677,0.451,0.549
48157674800,537,382,919,0.416,0.584
48157674900,868,583,1451,0.402,0.598
48157675000,810,488,1298,0.376,0.624
48157675200,1057,808,1865,0.433,0.567
48187210712,203,252,455,0.554,0.446
48187210710,122,146,268,0.545,0.455
48187210707,253,362,615,0.589,0.411
48187210709,263,320,583,0.549,0.451
48187210711,209,269,478,0.563,0.437
48439113809,457,387,844,0.459,0.541
48167721201,563,685,1248,0.549,0.451
48167722001,400,372,772,0.482,0.518
48167726200,1692,1274,2966,0.43,0.57
48439121609,566,431,997,0.432,0.568
48187210708,265,336,601,0.559,0.441
48201550301,361,240,601,0.399,0.601
48201550302,327,313,640,0.489,0.511
48157675800,1356,888,2244,0.396,0.604
48157670800,470,526,996,0.528,0.472
48157675700,1246,851,2097,0.406,0.594
48157673200,1141,743,1884,0.394,0.606
48157673400,1609,1477,3086,0.479,0.521
48157673300,966,642,1608,0.399,0.601
48201550401,303,272,575,0.473,0.527
48201553403,231,219,450,0.487,0.513
48201454502,154,157,311,0.505,0.495
48201541601,174,179,353,0.507,0.493
48201541602,418,439,857,0.512,0.488
48373210102,1940,1677,3617,0.464,0.536
48373210101,765,867,1632,0.531,0.469
48373210500,1779,1636,3415,0.479,0.521
48373210400,1674,1302,2976,0.438,0.562
48157670400,151,156,307,0.508,0.492
48157670300,176,169,345,0.49,0.51
48157670200,270,270,540,0.5,0.5
48157670700,595,589,1184,0.497,0.503
48201455102,185,128,313,0.409,0.591
48201511302,287,352,639,0.551,0.449
48201520601,134,104,238,0.437,0.563
48201554001,219,191,410,0.466,0.534
48201554901,318,305,623,0.49,0.51
48201212300,955,1004,1959,0.513,0.487
48201212400,656,578,1234,0.468,0.532
48157675300,1333,1047,2380,0.44,0.56
48157675600,926,598,1524,0.392,0.608
48157673700,150,97,247,0.393,0.607
48157675100,810,609,1419,0.429,0.571
48017950100,7917,1958,9875,0.198,0.802
48201250701,568,503,1071,0.47,0.53
48201250702,281,217,498,0.436,0.564
48201251503,52,61,113,0.54,0.46
48201251402,222,270,492,0.549,0.451
48201251902,585,357,942,0.379,0.621
48201314002,283,186,469,0.397,0.603
48201511002,197,225,422,0.533,0.467
48201511001,311,281,592,0.475,0.525
48201522302,226,184,410,0.449,0.551
48201522202,119,124,243,0.51,0.49
48201522301,198,174,372,0.468,0.532
48201522201,144,163,307,0.531,0.469
48201532002,73,88,161,0.547,0.453
48201532001,186,188,374,0.503,0.497
48201532502,178,189,367,0.515,0.485
48201543200,857,695,1552,0.448,0.552
48201522500,337,344,681,0.505,0.495
48355005414,81,124,205,0.605,0.395
48355003203,186,297,483,0.615,0.385
48355005404,88,128,216,0.593,0.407
48355003700,303,461,764,0.603,0.397
48355001903,194,324,518,0.625,0.375
48085031621,742,814,1556,0.523,0.477
48085031622,384,518,902,0.574,0.426
48085031623,309,355,664,0.535,0.465
48085031624,204,279,483,0.578,0.422
48085031626,257,303,560,0.541,0.459
48085031627,445,585,1030,0.568,0.432
48085031628,224,251,475,0.528,0.472
48085031630,267,305,572,0.533,0.467
48201314001,205,155,360,0.431,0.569
48201413202,114,102,216,0.472,0.528
48201320602,270,280,550,0.509,0.491
48201333202,280,230,510,0.451,0.549
48201321401,484,593,1077,0.551,0.449
48201323702,159,148,307,0.482,0.518
48201340203,163,170,333,0.511,0.489
48201342002,159,123,282,0.436,0.564
48201534001,181,197,378,0.521,0.479
48201533902,202,154,356,0.433,0.567
48201550603,214,186,400,0.465,0.535
48187210508,258,259,517,0.501,0.499
48187210608,194,290,484,0.599,0.401
48187210607,341,424,765,0.554,0.446
48187210713,268,360,628,0.573,0.427
48201550402,232,206,438,0.47,0.53
48201550601,128,134,262,0.511,0.489
48085031504,509,328,837,0.392,0.608
48085031611,408,485,893,0.543,0.457
48085031612,280,390,670,0.582,0.418
48085031613,584,738,1322,0.558,0.442
48413950300,5269,1217,6486,0.188,0.812
48355002101,197,352,549,0.641,0.359
48355002001,219,395,614,0.643,0.357
48355001702,129,196,325,0.603,0.397
48355002002,176,351,527,0.666,0.334
48355001904,218,386,604,0.639,0.361
48277000800,1167,668,1835,0.364,0.636
48277000900,658,435,1093,0.398,0.602
48277001000,578,400,978,0.409,0.591
48277000700,592,387,979,0.395,0.605
48277000500,1194,755,1949,0.387,0.613
48277000300,1370,851,2221,0.383,0.617
48277000200,2103,1210,3313,0.365,0.635
48277000600,818,487,1305,0.373,0.627
48049951200,1094,565,1659,0.341,0.659
48049950600,843,406,1249,0.325,0.675
48049950300,1700,1137,2837,0.401,0.599
48049950200,2008,1144,3152,0.363,0.637
48049950900,864,433,1297,0.334,0.666
48049950500,1319,496,1815,0.273,0.727
48201331602,223,198,421,0.47,0.53
48201552602,426,308,734,0.42,0.58
48201553802,396,329,725,0.454,0.546
48201314400,270,187,457,0.409,0.591
48201320601,154,184,338,0.544,0.456
48201350601,396,336,732,0.459,0.541
48201411502,391,234,625,0.374,0.626
48201431401,146,123,269,0.457,0.543
48201540502,186,204,390,0.523,0.477
48201511301,373,437,810,0.54,0.46
48201554401,560,513,1073,0.478,0.522
48201555502,712,595,1307,0.455,0.545
48201223001,146,152,298,0.51,0.49
48201330303,422,369,791,0.466,0.534
48201334003,307,303,610,0.497,0.503
48201343301,205,188,393,0.478,0.522
48201341501,279,225,504,0.446,0.554
48201341502,195,144,339,0.425,0.575
48201341301,289,271,560,0.484,0.516
48201340302,236,241,477,0.505,0.495
48201551701,306,316,622,0.508,0.492
48201551702,112,109,221,0.493,0.507
48201534202,297,299,596,0.502,0.498
48201540602,267,269,536,0.502,0.498
48251130213,620,456,1076,0.424,0.576
48251130602,717,517,1234,0.419,0.581
48251130212,300,267,567,0.471,0.529
48251130210,612,449,1061,0.423,0.577
48251130304,887,510,1397,0.365,0.635
48251130211,1029,757,1786,0.424,0.576
48251130303,677,387,1064,0.364,0.636
48251130601,1889,1201,3090,0.389,0.611
48251130214,797,626,1423,0.44,0.56
48251130407,759,460,1219,0.377,0.623
48355002602,140,243,383,0.634,0.366
48355002603,160,319,479,0.666,0.334
48355003204,154,245,399,0.614,0.386
48355003306,182,276,458,0.603,0.397
48355003303,90,154,244,0.631,0.369
48355003305,106,163,269,0.606,0.394
48439102800,452,323,775,0.417,0.583
48439111522,463,495,958,0.517,0.483
48439102401,705,510,1215,0.42,0.58
48439113109,357,328,685,0.479,0.521
48201330301,223,258,481,0.536,0.464
48201334001,246,199,445,0.447,0.553
48201533702,91,88,179,0.492,0.508
48201554501,140,122,262,0.466,0.534
48201343600,2453,2291,4744,0.483,0.517
48201222402,164,154,318,0.484,0.516
48201251501,137,174,311,0.559,0.441
48201432002,124,88,212,0.415,0.585
48201241500,1186,1028,2214,0.464,0.536
48201222501,160,138,298,0.463,0.537
48141000401,713,311,1024,0.304,0.696
48141001002,452,154,606,0.254,0.746
48141001900,436,157,593,0.265,0.735
48141010504,440,117,557,0.21,0.79
48201222401,144,123,267,0.461,0.539
48201222503,240,218,458,0.476,0.524
48201431501,154,136,290,0.469,0.531
48201350602,282,280,562,0.498,0.502
48201341302,159,104,263,0.395,0.605
48201341202,328,217,545,0.398,0.602
48201350801,211,200,411,0.487,0.513
48201341201,219,137,356,0.385,0.615
48141001112,359,184,543,0.339,0.661
48201410702,366,312,678,0.46,0.54
48201410701,317,342,659,0.519,0.481
48201540902,528,433,961,0.451,0.549
48201540601,223,226,449,0.503,0.497
48201541203,193,157,350,0.449,0.551
48201541002,502,466,968,0.481,0.519
48141001113,520,311,831,0.374,0.626
48141001201,323,163,486,0.335,0.665
48275950200,1901,1279,3180,0.402,0.598
48275950100,2678,1765,4443,0.397,0.603
48355003001,365,513,878,0.584,0.416
48355005412,195,299,494,0.605,0.395
48355005409,232,378,610,0.62,0.38
48355980000,89,113,202,0.559,0.441
48355001701,266,383,649,0.59,0.41
48209010806,246,213,459,0.464,0.536
48209010908,529,558,1087,0.513,0.487
48209010809,293,311,604,0.515,0.485
48209010701,308,472,780,0.605,0.395
48209010702,93,118,211,0.559,0.441
48209010905,570,651,1221,0.533,0.467
48209010907,399,540,939,0.575,0.425
48209010807,245,171,416,0.411,0.589
48209010805,192,271,463,0.585,0.415
48209010906,554,651,1205,0.54,0.46
48209010909,319,319,638,0.5,0.5
48141000101,606,311,917,0.339,0.661
48141000106,461,255,716,0.356,0.644
48141000107,410,236,646,0.365,0.635
48141000108,298,143,441,0.324,0.676
48141000109,232,163,395,0.413,0.587
48141000110,260,147,407,0.361,0.639
48201233701,632,613,1245,0.492,0.508
48201233703,425,437,862,0.507,0.493
48201533801,217,209,426,0.491,0.509
48201222502,297,312,609,0.512,0.488
48201240502,108,104,212,0.491,0.509
48201533802,216,228,444,0.514,0.486
48201410401,259,314,573,0.548,0.452
48201411501,280,222,502,0.442,0.558
48201431802,271,158,429,0.368,0.632
48201431801,206,167,373,0.448,0.552
48201413201,68,64,132,0.485,0.515
48201432801,515,335,850,0.394,0.606
48201421201,93,77,170,0.453,0.547
48141001202,315,160,475,0.337,0.663
48141001203,200,76,276,0.275,0.725
48141001301,332,165,497,0.332,0.668
48141001302,941,460,1401,0.328,0.672
48141001600,697,247,944,0.262,0.738
48141001700,910,316,1226,0.258,0.742
48039663400,511,371,882,0.421,0.579
48039663500,402,318,720,0.442,0.558
48039663600,341,287,628,0.457,0.543
48039663700,254,190,444,0.428,0.572
48201432702,189,188,377,0.499,0.501
48201432701,208,156,364,0.429,0.571
48201422702,163,196,359,0.546,0.454
48201422701,225,224,449,0.499,0.501
48201422402,163,201,364,0.552,0.448
48201541201,176,206,382,0.539,0.461
48201541202,208,223,431,0.517,0.483
48201542102,321,391,712,0.549,0.451
48201543003,296,377,673,0.56,0.44
48201553002,330,330,660,0.5,0.5
48201553001,279,264,543,0.486,0.514
48485012200,629,324,953,0.34,0.66
48485012400,697,383,1080,0.355,0.645
48485012600,800,393,1193,0.329,0.671
48485012700,602,306,908,0.337,0.663
48485012300,480,257,737,0.349,0.651
48201252200,1557,1245,2802,0.444,0.556
48457950300,291,396,687,0.576,0.424
48457950400,1036,1001,2037,0.491,0.509
48457950500,634,616,1250,0.493,0.507
48457950100,1509,1295,2804,0.462,0.538
48367140706,1592,954,2546,0.375,0.625
48367140408,839,436,1275,0.342,0.658
48367140102,1385,849,2234,0.38,0.62
48367140409,348,162,510,0.318,0.682
48367140703,1302,811,2113,0.384,0.616
48367140101,538,402,940,0.428,0.572
48141000111,206,103,309,0.333,0.667
48381021101,476,180,656,0.274,0.726
48381022002,549,188,737,0.255,0.745
48211950300,4898,1079,5977,0.181,0.819
48381022001,328,134,462,0.29,0.71
48381021608,441,192,633,0.303,0.697
48381021609,261,95,356,0.267,0.733
48141001800,343,127,470,0.27,0.73
48141002000,517,241,758,0.318,0.682
48141002100,619,215,834,0.258,0.742
48141002300,833,298,1131,0.263,0.737
48141002400,475,163,638,0.255,0.745
48141002500,1078,403,1481,0.272,0.728
48439113611,608,412,1020,0.404,0.596
48479001001,711,435,1146,0.38,0.62
48479001501,303,185,488,0.379,0.621
48479000300,302,191,493,0.387,0.613
48479000101,738,474,1212,0.391,0.609
48107950100,3027,728,3755,0.194,0.806
48107950300,1920,447,2367,0.189,0.811
48107950200,3427,795,4222,0.188,0.812
48015760502,1500,738,2238,0.33,0.67
48015760501,1110,552,1662,0.332,0.668
48503950400,3459,3402,6861,0.496,0.504
48503950600,679,665,1344,0.495,0.505
48503950500,575,546,1121,0.487,0.513
48503950200,3700,2332,6032,0.387,0.613
48265960301,1832,1175,3007,0.391,0.609
48265960302,2700,1676,4376,0.383,0.617
48265960402,736,553,1289,0.429,0.571
48485013200,723,404,1127,0.358,0.642
48423000300,1037,655,1692,0.387,0.613
48423000500,866,516,1382,0.373,0.627
48423000600,495,303,798,0.38,0.62
48499950302,2043,1001,3044,0.329,0.671
48423001401,1195,850,2045,0.416,0.584
48423000100,732,411,1143,0.36,0.64
48423001802,613,348,961,0.362,0.638
48423001700,1227,669,1896,0.353,0.647
48141002600,659,247,906,0.273,0.727
48141002800,836,312,1148,0.272,0.728
48141002900,532,218,750,0.291,0.709
48141003000,476,194,670,0.29,0.71
48141003100,325,116,441,0.263,0.737
48361021502,435,424,859,0.494,0.506
48361021501,70,50,120,0.417,0.583
48059030102,1397,554,1951,0.284,0.716
48479000200,688,424,1112,0.381,0.619
48479001900,839,659,1498,0.44,0.56
48423000201,557,348,905,0.385,0.615
48423002007,594,423,1017,0.416,0.584
48423002009,485,401,886,0.453,0.547
48423001801,869,430,1299,0.331,0.669
48423000202,490,294,784,0.375,0.625
48423001602,541,373,914,0.408,0.592
48423001500,1251,720,1971,0.365,0.635
48423002008,361,277,638,0.434,0.566
48423001601,727,408,1135,0.359,0.641
48423000400,732,420,1152,0.365,0.635
48423002200,311,278,589,0.472,0.528
48423000700,573,342,915,0.374,0.626
48423000900,726,456,1182,0.386,0.614
48423001000,687,405,1092,0.371,0.629
48357950300,1464,672,2136,0.315,0.685
48357950400,1218,585,1803,0.324,0.676
48357950100,2628,557,3185,0.175,0.825
48141003200,601,228,829,0.275,0.725
48423001101,657,431,1088,0.396,0.604
48423001102,369,225,594,0.379,0.621
48423001200,432,276,708,0.39,0.61
48311950100,2700,4150,6850,0.606,0.394
48423001803,378,266,644,0.413,0.587
48423001901,369,186,555,0.335,0.665
48423002003,274,169,443,0.381,0.619
48423002004,298,155,453,0.342,0.658
48423002006,401,210,611,0.344,0.656
48423001300,331,203,534,0.38,0.62
48485013501,1091,569,1660,0.343,0.657
48485013600,1747,891,2638,0.338,0.662
48485013700,1489,600,2089,0.287,0.713
48423000800,1088,665,1753,0.379,0.621
48113016612,1580,1375,2955,0.465,0.535
48265960401,111,80,191,0.419,0.581
48479000700,454,282,736,0.383,0.617
48479000800,337,204,541,0.377,0.623
48479000901,713,453,1166,0.389,0.611
48113012211,128,83,211,0.393,0.607
48113012400,467,420,887,0.474,0.526
48113016513,666,598,1264,0.473,0.527
48113016514,600,518,1118,0.463,0.537
48113016517,399,407,806,0.505,0.495
48113016518,378,404,782,0.517,0.483
48113016519,198,190,388,0.49,0.51
48113016605,729,564,1293,0.436,0.564
48113016606,710,728,1438,0.506,0.494
48113016607,177,159,336,0.473,0.527
48113016610,546,472,1018,0.464,0.536
48113016611,722,593,1315,0.451,0.549
48141003300,582,250,832,0.3,0.7
48141003403,649,302,951,0.318,0.682
48141003404,790,411,1201,0.342,0.658
48141003502,271,109,380,0.287,0.713
48141003602,455,173,628,0.275,0.725
48141003701,277,110,387,0.284,0.716
48059030101,735,273,1008,0.271,0.729
48201333100,150,162,312,0.519,0.481
48201350200,379,369,748,0.493,0.507
48201350300,376,371,747,0.497,0.503
48201350400,383,351,734,0.478,0.522
48201350500,373,344,717,0.48,0.52
48273020300,648,711,1359,0.523,0.477
48113013609,296,241,537,0.449,0.551
48113013610,513,497,1010,0.492,0.508
48113013611,318,193,511,0.378,0.622
48201420300,325,345,670,0.515,0.485
48201420500,177,138,315,0.438,0.562
48113015306,123,199,322,0.618,0.382
48113015401,491,526,1017,0.517,0.483
48113015403,160,183,343,0.534,0.466
48113015404,391,394,785,0.502,0.498
48113015500,549,477,1026,0.465,0.535
48113015600,401,355,756,0.47,0.53
48201333300,619,587,1206,0.487,0.513
48201980000,142,122,264,0.462,0.538
48201333600,181,236,417,0.566,0.434
48201333700,447,451,898,0.502,0.498
48201410100,487,541,1028,0.526,0.474
48201410200,252,271,523,0.518,0.482
48201410300,204,177,381,0.465,0.535
48201410500,522,627,1149,0.546,0.454
48201410600,489,365,854,0.427,0.573
48201410800,233,252,485,0.52,0.48
48201410900,167,175,342,0.512,0.488
48201420600,199,207,406,0.51,0.49
48201420700,280,358,638,0.561,0.439
48201420900,497,531,1028,0.517,0.483
48201431700,353,376,729,0.516,0.484
48201431900,293,180,473,0.381,0.619
48201333800,397,384,781,0.492,0.508
48113007914,148,99,247,0.401,0.599
48113013625,50,34,84,0.405,0.595
48113018134,264,314,578,0.543,0.457
48113017605,158,158,316,0.5,0.5
48473680400,41,21,62,0.339,0.661
48473680500,3018,1757,4775,0.368,0.632
48473680200,1668,856,2524,0.339,0.661
48473680300,2080,1029,3109,0.331,0.669
48473680100,386,257,643,0.4,0.6
48473680600,662,417,1079,0.386,0.614
48201411000,322,274,596,0.46,0.54
48201411100,225,275,500,0.55,0.45
48201411200,157,195,352,0.554,0.446
48201411300,216,119,335,0.355,0.645
48201411400,208,232,440,0.527,0.473
48201421000,383,343,726,0.472,0.528
48201432100,216,166,382,0.435,0.565
48201432200,254,216,470,0.46,0.54
48201432300,332,240,572,0.42,0.58
48201340100,390,347,737,0.471,0.529
48201521700,964,610,1574,0.388,0.612
48201521800,488,366,854,0.429,0.571
48201521900,267,256,523,0.489,0.511
48201522100,258,271,529,0.512,0.488
48201530100,317,230,547,0.42,0.58
48201530300,435,417,852,0.489,0.511
48061010602,93,92,185,0.497,0.503
48061010700,405,415,820,0.506,0.494
48201454900,266,219,485,0.452,0.548
48201455000,97,83,180,0.461,0.539
48201530400,273,196,469,0.418,0.582
48369950200,4041,1276,5317,0.24,0.76
48369950300,7026,1978,9004,0.22,0.78
48201530700,245,254,499,0.509,0.491
48201455200,505,373,878,0.425,0.575
48201455300,167,128,295,0.434,0.566
48231960800,955,750,1705,0.44,0.56
48231961100,1079,708,1787,0.396,0.604
48231961400,2375,955,3330,0.287,0.713
48231961600,1566,717,2283,0.314,0.686
48231960300,1287,727,2014,0.361,0.639
48231960900,859,664,1523,0.436,0.564
48007950400,706,767,1473,0.521,0.479
48007950100,1436,1848,3284,0.563,0.437
48007950200,229,264,493,0.535,0.465
48007950500,758,1147,1905,0.602,0.398
48007950300,1149,1186,2335,0.508,0.492
48009020200,3363,2878,6241,0.461,0.539
48009020300,2779,1999,4778,0.418,0.582
48009020100,564,332,896,0.371,0.629
48011950100,3557,949,4506,0.211,0.789
48201530800,396,402,798,0.504,0.496
48201531500,297,308,605,0.509,0.491
48201531600,276,311,587,0.53,0.47
48201531700,166,197,363,0.543,0.457
48201531800,81,98,179,0.547,0.453
48201531900,224,285,509,0.56,0.44
48201510100,493,485,978,0.496,0.504
48201510200,771,748,1519,0.492,0.508
48201510300,546,664,1210,0.549,0.451
48201510400,285,348,633,0.55,0.45
48201510500,295,320,615,0.52,0.48
48201510600,700,819,1519,0.539,0.461
48201532600,182,197,379,0.52,0.48
48201510800,691,811,1502,0.54,0.46
48061010800,600,823,1423,0.578,0.422
48201530900,165,208,373,0.558,0.442
48201531100,182,209,391,0.535,0.465
48201531300,223,203,426,0.477,0.523
48201531400,122,144,266,0.541,0.459
48201510900,667,670,1337,0.501,0.499
48489950500,738,2134,2872,0.743,0.257
48489950700,2339,3713,6052,0.614,0.386
48489950400,643,2083,2726,0.764,0.236
48489950600,456,1229,1685,0.729,0.271
48489950300,485,1678,2163,0.776,0.224
48419950300,430,277,707,0.392,0.608
48419950200,1020,665,1685,0.395,0.605
48029131700,668,990,1658,0.597,0.403
48029140100,244,254,498,0.51,0.49
48029140200,366,475,841,0.565,0.435
48029140300,311,337,648,0.52,0.48
48029140500,445,552,997,0.554,0.446
48029140700,515,672,1187,0.566,0.434
48029140800,439,486,925,0.525,0.475
48029140900,207,261,468,0.558,0.442
48029141000,232,244,476,0.513,0.487
48061011901,349,1185,1534,0.772,0.228
48419950600,1306,931,2237,0.416,0.584
48419950500,556,424,980,0.433,0.567
48419950100,966,871,1837,0.474,0.526
48419950400,1367,555,1922,0.289,0.711
48061010900,558,544,1102,0.494,0.506
48061011000,317,361,678,0.532,0.468
48061011100,340,370,710,0.521,0.479
48061011200,253,256,509,0.503,0.497
48061011301,147,162,309,0.524,0.476
48201532100,279,276,555,0.497,0.503
48201532300,446,327,773,0.423,0.577
48201532400,265,253,518,0.488,0.512
48245010300,327,285,612,0.466,0.534
48245010400,216,174,390,0.446,0.554
48155950100,2421,1560,3981,0.392,0.608
48029131200,179,172,351,0.49,0.51
48029141200,509,584,1093,0.534,0.466
48061011500,684,732,1416,0.517,0.483
48061011700,570,677,1247,0.543,0.457
48061011801,271,322,593,0.543,0.457
48061011802,147,183,330,0.555,0.445
48061011302,173,250,423,0.591,0.409
48201452900,157,161,318,0.506,0.494
48201453000,372,387,759,0.51,0.49
48201453100,104,103,207,0.498,0.502
48201530600,301,250,551,0.454,0.546
48245010600,349,303,652,0.465,0.535
48029131606,353,474,827,0.573,0.427
48201453300,379,232,611,0.38,0.62
48201511200,227,281,508,0.553,0.447
48201511500,862,1037,1899,0.546,0.454
48201511600,530,618,1148,0.538,0.462
48201520100,260,209,469,0.446,0.554
48029131300,478,550,1028,0.535,0.465
48245000900,354,273,627,0.435,0.565
48245002000,293,243,536,0.453,0.547
48245011600,1916,2202,4118,0.535,0.465
48201453700,393,406,799,0.508,0.492
48201453800,128,133,261,0.51,0.49
48201453900,355,362,717,0.505,0.495
48317950100,3419,1057,4476,0.236,0.764
48317950200,1953,824,2777,0.297,0.703
48245010100,205,158,363,0.435,0.565
48245011101,399,318,717,0.444,0.556
48245001303,402,384,786,0.489,0.511
48245006900,900,1006,1906,0.528,0.472
48245000103,110,112,222,0.505,0.495
48245011400,1395,1510,2905,0.52,0.48
48201454000,223,244,467,0.522,0.478
48309003602,1042,661,1703,0.388,0.612
48309003801,967,661,1628,0.406,0.594
48309001000,346,449,795,0.565,0.435
48309004102,534,380,914,0.416,0.584
48309003500,929,664,1593,0.417,0.583
48309003802,1785,1236,3021,0.409,0.591
48309002302,438,431,869,0.496,0.504
48309001800,452,428,880,0.486,0.514
48309003900,2343,1778,4121,0.431,0.569
48309002900,542,513,1055,0.486,0.514
48309003400,1022,800,1822,0.439,0.561
48309003601,1659,727,2386,0.305,0.695
48309001700,758,651,1409,0.462,0.538
48309003701,585,517,1102,0.469,0.531
48201520200,183,194,377,0.515,0.485
48201520500,903,684,1587,0.431,0.569
48201520700,202,234,436,0.537,0.463
48245001302,205,182,387,0.47,0.53
48245010800,972,935,1907,0.49,0.51
48245010901,301,249,550,0.453,0.547
48245010700,414,318,732,0.434,0.566
48201454100,155,165,320,0.516,0.484
48201454200,135,136,271,0.502,0.498
48245002400,338,261,599,0.436,0.564
48245000304,499,398,897,0.444,0.556
48245011500,567,455,1022,0.445,0.555
48245007100,437,372,809,0.46,0.54
48245000306,249,222,471,0.471,0.529
48201521000,199,173,372,0.465,0.535
48201521100,68,72,140,0.514,0.486
48201521200,184,186,370,0.503,0.497
48201521300,211,220,431,0.51,0.49
48201521400,186,172,358,0.48,0.52
48201521600,731,502,1233,0.407,0.593
48201454600,588,434,1022,0.425,0.575
48201454700,433,382,815,0.469,0.531
48201454800,412,331,743,0.445,0.555
48375013300,422,175,597,0.293,0.707
48375014100,339,123,462,0.266,0.734
48375014500,662,337,999,0.337,0.663
48375014700,1069,455,1524,0.299,0.701
48201550500,274,244,518,0.471,0.529
48201554700,435,331,766,0.432,0.568
48201555000,293,275,568,0.484,0.516
48201555100,316,323,639,0.505,0.495
48201241000,358,392,750,0.523,0.477
48201522000,159,155,314,0.494,0.506
48085031633,168,210,378,0.556,0.444
48085031634,116,145,261,0.556,0.444
48201550700,178,159,337,0.472,0.528
48201550800,149,117,266,0.44,0.56
48201550900,351,323,674,0.479,0.521
48385950100,3309,1332,4641,0.287,0.713
48201540800,373,320,693,0.462,0.538
48201541100,307,302,609,0.496,0.504
48201551000,122,113,235,0.481,0.519
48389950100,3549,1191,4740,0.251,0.749
48389950200,1477,449,1926,0.233,0.767
48389950300,1013,254,1267,0.2,0.8
48389950400,1489,474,1963,0.241,0.759
48389950500,2532,788,3320,0.237,0.763
48201551100,468,378,846,0.447,0.553
48291700300,940,855,1795,0.476,0.524
48291700400,516,426,942,0.452,0.548
48291700900,418,270,688,0.392,0.608
48291700500,480,459,939,0.489,0.511
48375014800,1117,477,1594,0.299,0.701
48375014900,430,222,652,0.34,0.66
48375015000,525,208,733,0.284,0.716
48375015100,407,183,590,0.31,0.69
48375015200,425,176,601,0.293,0.707
48201551200,495,412,907,0.454,0.546
48201551300,135,131,266,0.492,0.508
48201541300,291,280,571,0.49,0.51
48201541400,411,484,895,0.541,0.459
48201541500,173,195,368,0.53,0.47
48201551400,528,452,980,0.461,0.539
48201551500,682,617,1299,0.475,0.525
48201551600,252,233,485,0.48,0.52
48245001700,687,548,1235,0.444,0.556
48201541700,500,430,930,0.462,0.538
48201541800,329,281,610,0.461,0.539
48099010601,246,367,613,0.599,0.401
48099010702,183,258,441,0.585,0.415
48077030200,2216,718,2934,0.245,0.755
48077030301,2054,973,3027,0.321,0.679
48077030302,3023,1843,4866,0.379,0.621
48291700600,730,655,1385,0.473,0.527
48291701400,1366,1058,2424,0.436,0.564
48291701200,973,717,1690,0.424,0.576
48291700800,852,573,1425,0.402,0.598
48291701000,670,427,1097,0.389,0.611
48291700100,1161,1048,2209,0.474,0.526
48291700200,387,300,687,0.437,0.563
48291701300,1121,771,1892,0.408,0.592
48291700700,208,144,352,0.409,0.591
48291701100,882,552,1434,0.385,0.615
48201541900,252,284,536,0.53,0.47
48201542000,337,368,705,0.522,0.478
48113011602,783,633,1416,0.447,0.553
48113011701,562,466,1028,0.453,0.547
48113011702,682,583,1265,0.461,0.539
48201551800,426,376,802,0.469,0.531
48201551900,141,124,265,0.468,0.532
48201552400,386,347,733,0.473,0.527
48201552500,502,407,909,0.448,0.552
48201532800,120,120,240,0.5,0.5
48201532900,113,113,226,0.5,0.5
48201533000,114,114,228,0.5,0.5
48201542400,524,390,914,0.427,0.573
48201542500,154,102,256,0.398,0.602
48201542600,198,139,337,0.412,0.588
48201542700,411,343,754,0.455,0.545
48201552700,402,312,714,0.437,0.563
48251130205,462,326,788,0.414,0.586
48201533100,291,315,606,0.52,0.48
48201533200,233,257,490,0.524,0.476
48201533300,541,506,1047,0.483,0.517
48201533400,460,436,896,0.487,0.513
48201533500,262,261,523,0.499,0.501
48201533600,194,152,346,0.439,0.561
48271950100,4614,1692,6306,0.268,0.732
48475950200,1407,271,1678,0.162,0.838
48475950100,10047,3131,13178,0.238,0.762
48475950300,1328,259,1587,0.163,0.837
48201542800,281,216,497,0.435,0.565
48201550100,436,256,692,0.37,0.63
48201550200,148,90,238,0.378,0.622
48245001900,446,354,800,0.442,0.558
48245011001,435,336,771,0.436,0.564
48245011002,401,312,713,0.438,0.562
48113012000,416,367,783,0.469,0.531
48113012100,389,354,743,0.476,0.524
48113012204,554,437,991,0.441,0.559
48201552800,679,604,1283,0.471,0.529
48113012206,383,301,684,0.44,0.56
48113012207,643,501,1144,0.438,0.562
48201552900,463,416,879,0.473,0.527
48133950400,1076,609,1685,0.361,0.639
48133950200,2203,1828,4031,0.453,0.547
48133950100,1604,1228,2832,0.434,0.566
48133950300,2586,1910,4496,0.425,0.575
48133950500,1179,1062,2241,0.474,0.526
48201553100,270,270,540,0.5,0.5
48201553300,122,97,219,0.443,0.557
48201553500,221,221,442,0.5,0.5
48201553600,192,207,399,0.519,0.481
48251130208,582,415,997,0.416,0.584
48251131000,776,617,1393,0.443,0.557
48251131100,1005,771,1776,0.434,0.566
48251130409,1693,859,2552,0.337,0.663
48251130800,1693,1165,2858,0.408,0.592
48201534100,399,402,801,0.502,0.498
48439110703,428,324,752,0.431,0.569
48201540100,976,851,1827,0.466,0.534
48245002100,427,408,835,0.489,0.511
48245002200,472,474,946,0.501,0.499
48245002300,338,369,707,0.522,0.478
48245002500,337,274,611,0.448,0.552
48245002600,490,475,965,0.492,0.508
48245005100,385,453,838,0.541,0.459
48245005400,687,551,1238,0.445,0.555
48113011800,665,563,1228,0.458,0.542
48113012208,54,36,90,0.4,0.6
48201553700,240,228,468,0.487,0.513
48201554200,421,325,746,0.436,0.564
48201554600,278,230,508,0.453,0.547
48439113628,257,163,420,0.388,0.612
48439113629,416,269,685,0.393,0.607
48445950300,1373,270,1643,0.164,0.836
48201233200,390,351,741,0.474,0.526
48201233400,340,285,625,0.456,0.544
48201233500,411,390,801,0.487,0.513
48113010703,334,299,633,0.472,0.528
48113010704,425,344,769,0.447,0.553
48201311000,491,540,1031,0.524,0.476
48201311100,482,487,969,0.503,0.497
48201311300,335,356,691,0.515,0.485
48201311400,465,404,869,0.465,0.535
48201233600,388,373,761,0.49,0.51
48201240100,637,440,1077,0.409,0.591
48167720400,247,249,496,0.502,0.498
48167720700,917,819,1736,0.472,0.528
48167720900,638,471,1109,0.425,0.575
48201311500,386,404,790,0.511,0.489
48201311600,83,64,147,0.435,0.565
48201240600,148,119,267,0.446,0.554
48113980100,232,144,376,0.383,0.617
48201252000,742,798,1540,0.518,0.482
48113000605,252,136,388,0.351,0.649
48201311700,517,417,934,0.446,0.554
48201311800,330,284,614,0.463,0.537
48201311900,350,310,660,0.47,0.53
48201312000,176,178,354,0.503,0.497
48183001400,1250,761,2011,0.378,0.622
48307950300,5093,679,5772,0.118,0.882
48381021900,2631,927,3558,0.261,0.739
48307950400,2885,1125,4010,0.281,0.719
48307950500,3208,1016,4224,0.241,0.759
48113016407,325,353,678,0.521,0.479
48183000600,655,445,1100,0.405,0.595
48183010301,274,195,469,0.416,0.584
48183001200,384,251,635,0.395,0.605
48183000200,688,457,1145,0.399,0.601
48183010400,3183,1517,4700,0.323,0.677
48381021702,624,279,903,0.309,0.691
48381021801,1396,571,1967,0.29,0.71
48381020900,316,145,461,0.315,0.685
48381021602,298,126,424,0.297,0.703
48113007101,304,211,515,0.41,0.59
48113018002,232,215,447,0.481,0.519
48113016804,536,445,981,0.454,0.546
48113009105,271,252,523,0.482,0.518
48113012210,173,135,308,0.438,0.562
48113009610,129,58,187,0.31,0.69
48113014121,145,203,348,0.583,0.417
48113013713,48,53,101,0.525,0.475
48113004201,511,408,919,0.444,0.556
48113017001,1896,1456,3352,0.434,0.566
48113017102,735,570,1305,0.437,0.563
48113018124,962,1150,2112,0.545,0.455
48183010600,1263,627,1890,0.332,0.668
48183000900,903,514,1417,0.363,0.637
48183010200,2415,2113,4528,0.467,0.533
48201252100,649,397,1046,0.38,0.62
48201253000,462,282,744,0.379,0.621
48201253300,465,389,854,0.456,0.544
48201253400,751,607,1358,0.447,0.553
48113011105,241,227,468,0.485,0.515
48201312100,102,98,200,0.49,0.51
48201312200,545,514,1059,0.485,0.515
48201312400,389,391,780,0.501,0.499
48113005901,655,554,1209,0.458,0.542
48113006001,259,240,499,0.481,0.519
48113006002,248,231,479,0.482,0.518
48113006200,579,564,1143,0.493,0.507
48167721000,212,160,372,0.43,0.57
48167721100,701,523,1224,0.427,0.573
48113006301,451,403,854,0.472,0.528
48113006302,437,395,832,0.475,0.525
48113006501,368,316,684,0.462,0.538
48113006502,415,314,729,0.431,0.569
48203020200,1184,1061,2245,0.473,0.527
48203020102,1745,1444,3189,0.453,0.547
48203020401,706,566,1272,0.445,0.555
48203020402,922,711,1633,0.435,0.565
48397040200,707,463,1170,0.396,0.604
48397040301,328,393,721,0.545,0.455
48397040302,1179,740,1919,0.386,0.614
48381020100,243,99,342,0.289,0.711
48381020500,543,263,806,0.326,0.674
48383950100,5934,1197,7131,0.168,0.832
48113010801,550,468,1018,0.46,0.54
48113011200,579,571,1150,0.497,0.503
48113011300,571,564,1135,0.497,0.503
48201312500,809,630,1439,0.438,0.562
48201312600,746,666,1412,0.472,0.528
48201241200,266,287,553,0.519,0.481
48113001800,361,169,530,0.319,0.681
48113001900,519,272,791,0.344,0.656
48113002000,521,331,852,0.388,0.612
48113002100,770,352,1122,0.314,0.686
48201241300,810,859,1669,0.515,0.485
48201253500,445,308,753,0.409,0.591
48201253600,659,432,1091,0.396,0.604
48113001202,413,293,706,0.415,0.585
48113001203,135,113,248,0.456,0.544
48113015800,442,385,827,0.466,0.534
48113011900,613,567,1180,0.481,0.519
48113016903,1640,1302,2942,0.443,0.557
48113016617,458,441,899,0.491,0.509
48113008703,277,233,510,0.457,0.543
48113014002,1258,978,2236,0.437,0.563
48201312700,201,192,393,0.489,0.511
48201312800,135,115,250,0.46,0.54
48201312900,181,200,381,0.525,0.475
48201313100,411,291,702,0.415,0.585
48201313200,396,405,801,0.506,0.494
48201313300,184,211,395,0.534,0.466
48113014124,1642,979,2621,0.374,0.626
48113007700,434,389,823,0.473,0.527
48113013711,80,76,156,0.487,0.513
48113014114,76,129,205,0.629,0.371
48113015304,382,413,795,0.519,0.481
48113014703,39,42,81,0.519,0.481
48113016406,231,247,478,0.517,0.483
48113018205,178,258,436,0.592,0.408
48113011500,519,459,978,0.469,0.531
48113005902,285,256,541,0.473,0.527
48201323900,182,182,364,0.5,0.5
48217960400,542,514,1056,0.487,0.513
48217960600,364,386,750,0.515,0.485
48217960500,1468,1476,2944,0.501,0.499
48217960800,521,297,818,0.363,0.637
48217961000,395,231,626,0.369,0.631
48217960700,981,901,1882,0.479,0.521
48217960100,1888,1149,3037,0.378,0.622
48217960900,749,478,1227,0.39,0.61
48217960200,1886,1528,3414,0.448,0.552
48217961100,2279,1785,4064,0.439,0.561
48201324000,578,512,1090,0.47,0.53
48201330100,215,267,482,0.554,0.446
48201330200,171,173,344,0.503,0.497
48201330400,191,217,408,0.532,0.468
48201330500,145,178,323,0.551,0.449
48303002204,636,194,830,0.234,0.766
48303002300,612,236,848,0.278,0.722
48303002400,1327,489,1816,0.269,0.731
48303000302,954,310,1264,0.245,0.755
48303001502,501,204,705,0.289,0.711
48167721300,332,365,697,0.524,0.476
48167721400,417,300,717,0.418,0.582
48113007601,273,260,533,0.488,0.512
48113007604,488,432,920,0.47,0.53
48113007605,277,248,525,0.472,0.528
48113007801,298,218,516,0.422,0.578
48113007804,355,285,640,0.445,0.555
48113007805,310,236,546,0.432,0.568
48303010101,1266,275,1541,0.178,0.822
48303010502,361,140,501,0.279,0.721
48303010504,489,201,690,0.291,0.709
48201330600,303,303,606,0.5,0.5
48201330700,328,327,655,0.499,0.501
48201330800,867,818,1685,0.485,0.515
48303000100,889,334,1223,0.273,0.727
48303000201,961,263,1224,0.215,0.785
48303000202,479,128,607,0.211,0.789
48303000301,303,83,386,0.215,0.785
48303000402,432,178,610,0.292,0.708
48303000403,522,230,752,0.306,0.694
48303000404,620,271,891,0.304,0.696
48439103701,455,347,802,0.433,0.567
48439103800,742,484,1226,0.395,0.605
48113007811,131,108,239,0.452,0.548
48439103702,325,214,539,0.397,0.603
48303002500,1740,505,2245,0.225,0.775
48303010102,414,119,533,0.223,0.777
48303010302,625,267,892,0.299,0.701
48113004700,377,242,619,0.391,0.609
48113004800,504,326,830,0.393,0.607
48113004900,502,446,948,0.47,0.53
48201320500,449,479,928,0.516,0.484
48113005000,408,270,678,0.398,0.602
48113005100,316,258,574,0.449,0.551
48113005200,403,354,757,0.468,0.532
48113002500,955,617,1572,0.392,0.608
48113002702,478,332,810,0.41,0.59
48113019019,156,135,291,0.464,0.536
48025950500,902,951,1853,0.513,0.487
48303010402,357,117,474,0.247,0.753
48303010404,781,294,1075,0.273,0.727
48303010505,460,190,650,0.292,0.708
48201320700,385,333,718,0.464,0.536
48201320800,763,913,1676,0.545,0.455
48201320900,319,376,695,0.541,0.459
48257050206,1958,1179,3137,0.376,0.624
48257050203,751,479,1230,0.389,0.611
48257050704,809,413,1222,0.338,0.662
48201321000,394,417,811,0.514,0.486
48257051202,1082,552,1634,0.338,0.662
48257051201,870,436,1306,0.334,0.666
48257050205,832,482,1314,0.367,0.633
48257050703,335,178,513,0.347,0.653
48303010506,698,213,911,0.234,0.766
48303010600,2663,425,3088,0.138,0.862
48499950500,660,435,1095,0.397,0.603
48499950100,1674,912,2586,0.353,0.647
48201321100,805,742,1547,0.48,0.52
48201321200,153,142,295,0.481,0.519
48201321500,180,159,339,0.469,0.531
48201321600,452,532,984,0.541,0.459
48331950402,1775,869,2644,0.329,0.671
48245011303,413,475,888,0.535,0.465
48303000405,883,329,1212,0.271,0.729
48303000500,618,198,816,0.243,0.757
48303000605,201,57,258,0.221,0.779
48303000607,437,151,588,0.257,0.743
48113005400,674,713,1387,0.514,0.486
48113005500,778,703,1481,0.475,0.525
48113005300,823,753,1576,0.478,0.522
48113005600,563,512,1075,0.476,0.524
48113013624,83,53,136,0.39,0.61
48201330900,446,411,857,0.48,0.52
48201331100,724,633,1357,0.466,0.534
48201331200,309,287,596,0.482,0.518
48201331300,334,335,669,0.501,0.499
48201331400,88,64,152,0.421,0.579
48201331500,338,402,740,0.543,0.457
48113005700,823,696,1519,0.458,0.542
48499950800,1776,790,2566,0.308,0.692
48499950400,1120,562,1682,0.334,0.666
48499950700,1450,672,2122,0.317,0.683
48499950200,793,534,1327,0.402,0.598
48113007815,138,80,218,0.367,0.633
48113007818,125,104,229,0.454,0.546
48113007819,61,47,108,0.435,0.565
48113007902,618,572,1190,0.481,0.519
48303000700,2145,562,2707,0.208,0.792
48201321700,237,265,502,0.528,0.472
48201321900,312,365,677,0.539,0.461
48201322000,128,113,241,0.469,0.531
48201322100,316,295,611,0.483,0.517
48201322200,176,181,357,0.507,0.493
48201331700,252,293,545,0.538,0.462
48201331800,242,236,478,0.494,0.506
48201331900,207,219,426,0.514,0.486
48201332100,181,179,360,0.497,0.503
48201332200,399,415,814,0.51,0.49
48201332400,193,240,433,0.554,0.446
48201332500,207,251,458,0.548,0.452
48113002200,801,430,1231,0.349,0.651
48113002400,623,441,1064,0.414,0.586
48113002701,462,357,819,0.436,0.564
48121021728,155,125,280,0.446,0.554
48303001000,1512,457,1969,0.232,0.768
48279950100,3305,846,4151,0.204,0.796
48279950500,3266,846,4112,0.206,0.794
48279950200,2834,741,3575,0.207,0.793
48279950600,2200,565,2765,0.204,0.796
48279950300,6182,1484,7666,0.194,0.806
48285000300,1024,861,1885,0.457,0.543
48285000500,1186,1106,2292,0.483,0.517
48285000400,1511,1067,2578,0.414,0.586
48285000600,874,716,1590,0.45,0.55
48285000200,1362,957,2319,0.413,0.587
48285000100,1818,1350,3168,0.426,0.574
48483950100,4734,1047,5781,0.181,0.819
48483950300,5290,1035,6325,0.164,0.836
48303001200,685,213,898,0.237,0.763
48303001300,1055,345,1400,0.246,0.754
48303001400,771,290,1061,0.273,0.727
48303001601,353,138,491,0.281,0.719
48303001602,847,336,1183,0.284,0.716
48201322700,300,330,630,0.524,0.476
48201322800,382,399,781,0.511,0.489
48303001702,594,261,855,0.305,0.695
48303001705,649,256,905,0.283,0.717
48089750400,2673,2227,4900,0.454,0.546
48089750100,1517,1341,2858,0.469,0.531
48089750300,1533,1603,3136,0.511,0.489
48089750500,1811,1504,3315,0.454,0.546
48089750200,1343,1311,2654,0.494,0.506
48309002000,472,450,922,0.488,0.512
48309000598,963,1080,2043,0.529,0.471
48113008000,751,699,1450,0.482,0.518
48113008100,825,654,1479,0.442,0.558
48113008200,487,416,903,0.461,0.539
48439103500,1018,712,1730,0.412,0.588
48303001707,562,234,796,0.294,0.706
48303001706,816,278,1094,0.254,0.746
48303001803,628,256,884,0.29,0.71
48087950300,6236,1444,7680,0.188,0.812
48137950300,3856,1315,5171,0.254,0.746
48327950300,3086,644,3730,0.173,0.827
48303001804,409,154,563,0.274,0.726
48303001901,870,414,1284,0.322,0.678
48303001903,743,327,1070,0.306,0.694
48303001904,242,93,335,0.278,0.722
48201322900,278,316,594,0.532,0.468
48201323000,250,208,458,0.454,0.546
48201323100,234,230,464,0.496,0.504
48201323200,248,302,550,0.549,0.451
48201323300,233,206,439,0.469,0.531
48201323400,263,336,599,0.561,0.439
48201323500,180,191,371,0.515,0.485
48201323600,423,417,840,0.496,0.504
48303002001,408,192,600,0.32,0.68
48303002002,459,202,661,0.306,0.694
48303002101,729,292,1021,0.286,0.714
48303002202,541,208,749,0.278,0.722
48303002203,358,132,490,0.269,0.731
48201411700,193,148,341,0.434,0.566
48201411800,374,333,707,0.471,0.529
48201411900,389,395,784,0.504,0.496
48201412000,355,392,747,0.525,0.475
48253020200,1811,270,2081,0.13,0.87
48253020400,3077,527,3604,0.146,0.854
48253020101,1059,326,1385,0.235,0.765
48253020102,54,9,63,0.143,0.857
48253020300,2607,464,3071,0.151,0.849
48253020500,2758,1008,3766,0.268,0.732
48201432400,387,275,662,0.415,0.585
48201432500,249,182,431,0.422,0.578
48201432600,322,204,526,0.388,0.612
48201340500,239,226,465,0.486,0.514
48201340600,134,132,266,0.496,0.504
48201340800,219,211,430,0.491,0.509
48201341000,258,209,467,0.448,0.552
48201412100,107,96,203,0.473,0.527
48201433300,346,347,693,0.501,0.499
48201433100,76,55,131,0.42,0.58
48201433600,361,246,607,0.405,0.595
48201433400,221,166,387,0.429,0.571
48201440100,531,449,980,0.458,0.542
48201450100,75,84,159,0.528,0.472
48201450200,392,366,758,0.483,0.517
48201450300,591,477,1068,0.447,0.553
48201450400,331,259,590,0.439,0.561
48439104602,462,311,773,0.402,0.598
48201450500,430,377,807,0.467,0.533
48201341100,383,223,606,0.368,0.632
48201450600,262,236,498,0.474,0.526
48201450700,396,383,779,0.492,0.508
48201450900,276,227,503,0.451,0.549
48201451100,243,231,474,0.487,0.513
48201451200,162,151,313,0.482,0.518
48201451300,466,397,863,0.46,0.54
48201421500,305,225,530,0.425,0.575
48201421600,252,209,461,0.453,0.547
48201421700,261,264,525,0.503,0.497
48201341800,158,169,327,0.517,0.483
48201451700,130,128,258,0.496,0.504
48201451800,216,202,418,0.483,0.517
48439104604,529,458,987,0.464,0.536
48289950100,1586,1457,3043,0.479,0.521
48289950300,1489,1155,2644,0.437,0.563
48289950200,2525,1730,4255,0.407,0.593
48201421800,212,233,445,0.524,0.476
48201421900,215,264,479,0.551,0.449
48201422100,304,335,639,0.524,0.476
48201422200,181,159,340,0.468,0.532
48201422500,297,277,574,0.483,0.517
48201422600,282,336,618,0.544,0.456
48201342100,416,356,772,0.461,0.539
48201342200,313,299,612,0.489,0.511
48201342300,316,315,631,0.499,0.501
48201342400,228,199,427,0.466,0.534
48439104100,619,459,1078,0.426,0.574
48439104201,489,381,870,0.438,0.562
48439104202,489,402,891,0.451,0.549
48439104300,889,639,1528,0.418,0.582
48439104400,757,561,1318,0.426,0.574
48439104504,455,308,763,0.404,0.596
48439104505,517,359,876,0.41,0.59
48201342500,467,436,903,0.483,0.517
48201342700,307,297,604,0.492,0.508
48201342800,417,384,801,0.479,0.521
48201422800,302,251,553,0.454,0.546
48201422900,266,235,501,0.469,0.531
48201423000,152,138,290,0.476,0.524
48439104601,697,537,1234,0.435,0.565
48201451500,147,120,267,0.449,0.551
48201423100,234,179,413,0.433,0.567
48201343000,293,323,616,0.524,0.476
48201343200,147,160,307,0.521,0.479
48201452000,200,160,360,0.444,0.556
48201452100,327,262,589,0.445,0.555
48201452400,328,313,641,0.488,0.512
48201452500,484,498,982,0.507,0.493
48201452700,386,394,780,0.505,0.495
48201423600,305,351,656,0.535,0.465
48113011401,483,429,912,0.47,0.53
48061013902,238,284,522,0.544,0.456
48061014100,641,909,1550,0.586,0.414
48061010201,323,656,979,0.67,0.33
48201412200,393,430,823,0.522,0.478
48201412300,499,622,1121,0.555,0.445
48029161600,332,455,787,0.578,0.422
48029980003,278,280,558,0.502,0.498
48029170101,373,442,815,0.542,0.458
48201412400,385,479,864,0.554,0.446
48029170200,842,1016,1858,0.547,0.453
48029170300,749,919,1668,0.551,0.449
48029170401,603,786,1389,0.566,0.434
48201332600,452,455,907,0.502,0.498
48201412700,300,312,612,0.51,0.49
48201412800,305,367,672,0.546,0.454
48201412900,373,367,740,0.496,0.504
48201413100,186,225,411,0.547,0.453
48273020100,2746,3950,6696,0.59,0.41
48273020500,701,731,1432,0.51,0.49
48273020400,692,718,1410,0.509,0.491
48273020200,731,758,1489,0.509,0.491
48337950300,1476,747,2223,0.336,0.664
48337950200,1623,1090,2713,0.402,0.598
48337950500,1907,1032,2939,0.351,0.649
48337950100,1893,1374,3267,0.421,0.579
48201430200,56,57,113,0.504,0.496
48201430300,263,302,565,0.535,0.465
48201430400,204,223,427,0.522,0.478
48201430500,296,252,548,0.46,0.54
48201413300,507,552,1059,0.521,0.479
48201420200,152,175,327,0.535,0.465
48201430600,200,227,427,0.532,0.468
48201430700,317,239,556,0.43,0.57
48201430800,517,385,902,0.427,0.573
48201430900,278,309,587,0.526,0.474
48029170402,577,691,1268,0.545,0.455
48201431000,426,438,864,0.507,0.493
48029170500,572,736,1308,0.563,0.437
48029171912,249,185,434,0.426,0.574
48201332700,473,420,893,0.47,0.53
48201332800,329,334,663,0.504,0.496
48201333000,209,230,439,0.524,0.476
48029172002,541,740,1281,0.578,0.422
48029180201,463,564,1027,0.549,0.451
48029180300,332,461,793,0.581,0.419
48029180400,171,293,464,0.631,0.369
48029180501,160,262,422,0.621,0.379
48439111516,687,549,1236,0.444,0.556
48029180504,113,197,310,0.635,0.365
48029180602,164,242,406,0.596,0.404
48029180701,196,265,461,0.575,0.425
48029180702,305,313,618,0.506,0.494
48439104603,403,285,688,0.414,0.586
48029180503,133,225,358,0.628,0.372
48029180800,166,291,457,0.637,0.363
48029180901,301,662,963,0.687,0.313
48439113916,361,302,663,0.456,0.544
48439111505,313,269,582,0.462,0.538
48493000104,630,407,1037,0.392,0.608
48493000404,848,594,1442,0.412,0.588
48493000103,590,427,1017,0.42,0.58
48029180902,414,802,1216,0.66,0.34
48029181001,232,361,593,0.609,0.391
48029181003,83,81,164,0.494,0.506
48029181004,90,111,201,0.552,0.448
48029181005,60,77,137,0.562,0.438
48029181100,282,463,745,0.621,0.379
48029181200,262,381,643,0.593,0.407
48029181301,103,134,237,0.565,0.435
48029181302,168,216,384,0.562,0.438
48029181402,148,90,238,0.378,0.622
48029181504,189,143,332,0.431,0.569
48029181505,346,335,681,0.492,0.508
48029181506,256,238,494,0.482,0.518
48029181601,238,252,490,0.514,0.486
48029181703,296,240,536,0.448,0.552
48029181704,376,283,659,0.429,0.571
48029181705,320,308,628,0.49,0.51
48029181711,251,187,438,0.427,0.573
48029181712,154,99,253,0.391,0.609
48029181713,311,216,527,0.41,0.59
48029181715,175,116,291,0.399,0.601
48029181716,260,192,452,0.425,0.575
48157673101,1685,1727,3412,0.506,0.494
48157673102,797,854,1651,0.517,0.483
48029181718,224,167,391,0.427,0.573
48029181809,237,188,425,0.442,0.558
48029181811,128,107,235,0.455,0.545
48029190200,619,945,1564,0.604,0.396
48029190400,296,481,777,0.619,0.381
48029190501,373,450,823,0.547,0.453
48029190601,421,489,910,0.537,0.463
48029190800,376,598,974,0.614,0.386
48029190901,407,709,1116,0.635,0.365
48027022103,221,252,473,0.533,0.467
48027022200,148,156,304,0.513,0.487
48027022300,381,365,746,0.489,0.511
48371950300,2560,736,3296,0.223,0.777
48371950100,5962,1646,7608,0.216,0.784
48371950400,2116,629,2745,0.229,0.771
48371950500,11497,2573,14070,0.183,0.817
48029191003,229,435,664,0.655,0.345
48029191004,168,257,425,0.605,0.395
48029191101,241,368,609,0.604,0.396
48029191102,205,398,603,0.66,0.34
48439111521,527,533,1060,0.503,0.497
48439114205,661,462,1123,0.411,0.589
48027023500,376,478,854,0.56,0.44
48029191406,227,301,528,0.57,0.43
48041002010,506,551,1057,0.521,0.479
48185180400,119,67,186,0.36,0.64
48401950400,1273,753,2026,0.372,0.628
48401950200,456,242,698,0.347,0.653
48401950700,477,447,924,0.484,0.516
48401950100,834,630,1464,0.43,0.57
48029191408,52,68,120,0.567,0.433
48029191409,133,202,335,0.603,0.397
48401950900,433,417,850,0.491,0.509
48401951100,1276,890,2166,0.411,0.589
48401950600,777,500,1277,0.392,0.608
48401951000,1083,540,1623,0.333,0.667
48401951200,831,592,1423,0.416,0.584
48401950300,1460,707,2167,0.326,0.674
48401950800,662,536,1198,0.447,0.553
48391950200,1153,1244,2397,0.519,0.481
48029181808,79,61,140,0.436,0.564
48027021201,170,181,351,0.516,0.484
48027021202,330,245,575,0.426,0.574
48027021301,233,174,407,0.428,0.572
48027021901,369,340,709,0.48,0.52
48027022101,185,253,438,0.578,0.422
48141004312,452,206,658,0.313,0.687
48121021523,170,146,316,0.462,0.538
48121021611,244,366,610,0.6,0.4
48027022401,273,246,519,0.474,0.526
48027022600,300,316,616,0.513,0.487
48027022900,210,227,437,0.519,0.481
48027023000,417,452,869,0.52,0.48
48027023103,262,270,532,0.508,0.492
48027023104,218,297,515,0.577,0.423
48121021612,176,264,440,0.6,0.4
48121021613,148,241,389,0.62,0.38
48121021614,205,329,534,0.616,0.384
48121021616,154,267,421,0.634,0.366
48141003702,229,101,330,0.306,0.694
48141003801,439,193,632,0.305,0.695
48439113810,451,383,834,0.459,0.541
48147950100,1417,679,2096,0.324,0.676
48147950500,1761,833,2594,0.321,0.679
48147950600,1110,605,1715,0.353,0.647
48147950300,1066,927,1993,0.465,0.535
48147950702,860,711,1571,0.453,0.547
48147950701,1469,765,2234,0.342,0.658
48121020601,335,552,887,0.622,0.378
48029190504,307,441,748,0.59,0.41
48029190503,351,575,926,0.621,0.379
48141000112,356,221,577,0.383,0.617
48141000204,452,242,694,0.349,0.651
48141000205,439,201,640,0.314,0.686
48141000206,465,285,750,0.38,0.62
48141000302,448,180,628,0.287,0.713
48215024402,314,801,1115,0.718,0.282
48215023600,752,1754,2506,0.7,0.3
48215024105,304,670,974,0.688,0.312
48215023102,640,1301,1941,0.67,0.33
48215021202,443,949,1392,0.682,0.318
48183000502,366,221,587,0.376,0.624
48183000700,623,394,1017,0.387,0.613
48183000800,468,279,747,0.373,0.627
48183001000,494,282,776,0.363,0.637
48215020503,409,883,1292,0.683,0.317
48215024600,945,2264,3209,0.706,0.294
48215022001,753,1593,2346,0.679,0.321
48215021401,565,1068,1633,0.654,0.346
48215024301,1781,1900,3681,0.516,0.484
48215023504,432,1217,1649,0.738,0.262
48215023902,625,1425,2050,0.695,0.305
48215022502,374,1206,1580,0.763,0.237
48215022900,651,1274,1925,0.662,0.338
48215021000,771,1551,2322,0.668,0.332
48215021303,390,1149,1539,0.747,0.253
48215023503,506,1280,1786,0.717,0.283
48215024000,535,1121,1656,0.677,0.323
48215024302,433,954,1387,0.688,0.312
48215022300,411,1393,1804,0.772,0.228
48215021901,294,820,1114,0.736,0.264
48113008802,445,346,791,0.437,0.563
48183001100,1070,561,1631,0.344,0.656
48113008900,424,349,773,0.451,0.549
48303010200,2970,682,3652,0.187,0.813
48001950500,703,647,1350,0.479,0.521
48001950100,1148,1017,2165,0.47,0.53
48001950700,621,574,1195,0.48,0.52
48001950600,792,685,1477,0.464,0.536
48001951000,993,989,1982,0.499,0.501
48001950800,591,540,1131,0.477,0.523
48215021100,777,1472,2249,0.655,0.345
48215021500,462,903,1365,0.662,0.338
48453000402,257,599,856,0.7,0.3
48439102201,451,406,857,0.474,0.526
48121021627,504,603,1107,0.545,0.455
48085030512,359,262,621,0.422,0.578
48085031632,397,458,855,0.536,0.464
48085031625,307,445,752,0.592,0.408
48085031506,855,487,1342,0.363,0.637
48085031900,1533,1485,3018,0.492,0.508
48085030100,1415,850,2265,0.375,0.625
48085031001,918,507,1425,0.356,0.644
48215023000,550,735,1285,0.572,0.428
48215024106,401,812,1213,0.669,0.331
48215020201,319,811,1130,0.718,0.282
48209010804,931,843,1774,0.475,0.525
48209010304,276,450,726,0.62,0.38
48209010910,357,363,720,0.504,0.496
48209010803,506,404,910,0.444,0.556
48209010808,362,310,672,0.461,0.539
48209010303,320,481,801,0.6,0.4
48215020202,359,815,1174,0.694,0.306
48215020501,324,525,849,0.618,0.382
48215020600,269,533,802,0.665,0.335
48387950600,727,669,1396,0.479,0.521
48387950100,730,862,1592,0.541,0.459
48387950500,1436,1635,3071,0.532,0.468
48361020700,491,491,982,0.5,0.5
48361021100,331,296,627,0.472,0.528
48361021600,254,345,599,0.576,0.424
48361022300,1013,1084,2097,0.517,0.483
48361021700,379,406,785,0.517,0.483
48361021200,483,500,983,0.509,0.491
48361020300,1038,1023,2061,0.496,0.504
48361022000,498,538,1036,0.519,0.481
48361021800,383,419,802,0.522,0.478
48361021000,171,245,416,0.589,0.411
48361022400,613,656,1269,0.517,0.483
48361022200,447,638,1085,0.588,0.412
48361021400,405,366,771,0.475,0.525
48361021900,640,631,1271,0.496,0.504
48097000700,1140,1184,2324,0.509,0.491
48097000900,2133,1955,4088,0.478,0.522
48097000100,2224,2005,4229,0.474,0.526
48097000500,931,713,1644,0.434,0.566
48097000400,1110,956,2066,0.463,0.537
48097000200,2472,1685,4157,0.405,0.595
48453000500,270,555,825,0.673,0.327
48255970400,610,585,1195,0.49,0.51
48255970100,1275,1473,2748,0.536,0.464
48255970300,1496,1278,2774,0.461,0.539
48255970200,1736,1246,2982,0.418,0.582
48065950100,6155,1434,7589,0.189,0.811
48065950200,4594,1475,6069,0.243,0.757
48113009603,561,471,1032,0.456,0.544
48113009604,518,384,902,0.426,0.574
48113009605,227,173,400,0.432,0.568
48113009607,259,234,493,0.475,0.525
48113009608,296,241,537,0.449,0.551
48113009609,388,323,711,0.454,0.546
48113009611,254,201,455,0.442,0.558
48113009702,285,276,561,0.492,0.508
48313000300,860,492,1352,0.364,0.636
48313000100,380,256,636,0.403,0.597
48313000200,528,303,831,0.365,0.635
48313000400,1126,406,1532,0.265,0.735
48337950600,888,762,1650,0.462,0.538
48337950400,2434,2246,4680,0.48,0.52
48215020701,274,700,974,0.719,0.281
48215020721,213,450,663,0.679,0.321
48105950100,5244,1222,6466,0.189,0.811
48215020723,358,627,985,0.637,0.363
48361020200,1027,863,1890,0.457,0.543
48453000601,155,209,364,0.574,0.426
48453000603,179,270,449,0.601,0.399
48453000604,153,205,358,0.573,0.427
48453000801,97,232,329,0.705,0.295
48453000802,164,379,543,0.698,0.302
48453000803,383,878,1261,0.696,0.304
48453000804,266,602,868,0.694,0.306
48453000901,213,481,694,0.693,0.307
48361020500,467,443,910,0.487,0.513
48029130402,317,374,691,0.541,0.459
48029131503,293,465,758,0.613,0.387
48215020724,244,416,660,0.63,0.37
48215020402,478,862,1340,0.643,0.357
48215020802,608,1338,1946,0.688,0.312
48215020901,353,880,1233,0.714,0.286
48399950500,4077,559,4636,0.121,0.879
48399950600,6738,1243,7981,0.156,0.844
48399950100,4176,1059,5235,0.202,0.798
48399950200,1573,364,1937,0.188,0.812
48215021201,380,766,1146,0.668,0.332
48215021600,303,532,835,0.637,0.363
48215022201,335,980,1315,0.745,0.255
48215022501,162,530,692,0.766,0.234
48215022600,178,589,767,0.768,0.232
48341950100,1611,615,2226,0.276,0.724
48341950200,3747,1250,4997,0.25,0.75
48341950300,894,407,1301,0.313,0.687
48341950400,644,388,1032,0.376,0.624
48097000600,813,680,1493,0.455,0.545
48361020900,378,311,689,0.451,0.549
48113009202,470,385,855,0.45,0.55
48113009301,503,431,934,0.461,0.539
48113009304,581,511,1092,0.468,0.532
48019000101,1733,973,2706,0.36,0.64
48021950502,1267,1277,2544,0.502,0.498
48215022701,379,1249,1628,0.767,0.233
48215022702,227,768,995,0.772,0.228
48215023700,477,877,1354,0.648,0.352
48215024201,1279,1892,3171,0.597,0.403
48215024500,717,1180,1897,0.622,0.378
48215021302,542,1440,1982,0.727,0.273
48215022800,1096,2748,3844,0.715,0.285
48215023507,355,1162,1517,0.766,0.234
48027980003,177,206,383,0.538,0.462
48027023403,1070,975,2045,0.477,0.523
48027023404,1083,687,1770,0.388,0.612
48027021903,383,489,872,0.561,0.439
48027023204,229,268,497,0.539,0.461
48027980002,57,72,129,0.558,0.442
48303010406,905,308,1213,0.254,0.746
48303010405,1025,321,1346,0.238,0.762
48303010408,1368,489,1857,0.263,0.737
48141000403,429,172,601,0.286,0.714
48141000404,233,83,316,0.263,0.737
48141001001,433,146,579,0.252,0.748
48141001104,500,301,801,0.376,0.624
48439113514,338,242,580,0.417,0.583
48477170100,882,485,1367,0.355,0.645
48477170600,1365,757,2122,0.357,0.643
48477170400,1707,1018,2725,0.374,0.626
48477170500,2852,1643,4495,0.366,0.634
48477170300,1414,848,2262,0.375,0.625
48477170200,1527,892,2419,0.369,0.631
48121020800,536,593,1129,0.525,0.475
48121020401,1488,1454,2942,0.494,0.506
48121020202,1581,1526,3107,0.491,0.509
48121020303,1668,1933,3601,0.537,0.463
48121021403,1220,789,2009,0.393,0.607
48141003803,243,114,357,0.319,0.681
48141003804,205,90,295,0.305,0.695
48141003901,219,80,299,0.268,0.732
48029121908,80,135,215,0.628,0.372
48029110300,495,548,1043,0.525,0.475
48141003902,458,146,604,0.242,0.758
48281950301,620,698,1318,0.53,0.47
48453001603,409,823,1232,0.668,0.332
48453001605,323,625,948,0.659,0.341
48453001606,26,46,72,0.639,0.361
48267950100,4338,1565,5903,0.265,0.735
48267950200,1205,332,1537,0.216,0.784
48269950100,3019,1094,4113,0.266,0.734
48121021615,239,436,675,0.646,0.354
48121020305,793,722,1515,0.477,0.523
48121020402,491,679,1170,0.58,0.42
48121020403,687,977,1664,0.587,0.413
48121020602,450,800,1250,0.64,0.36
48083950700,5019,1493,6512,0.229,0.771
48043950400,1347,369,1716,0.215,0.785
48043950300,3032,765,3797,0.201,0.799
48083950300,4013,547,4560,0.12,0.88
48083950600,4469,1454,5923,0.245,0.755
48141001501,533,290,823,0.352,0.648
48141010404,796,295,1091,0.27,0.73
48141004201,480,211,691,0.305,0.695
48141003501,754,304,1058,0.287,0.713
48303010508,1804,533,2337,0.228,0.772
48303001801,696,309,1005,0.307,0.693
48303010301,1425,385,1810,0.213,0.787
48303000900,834,220,1054,0.209,0.791
48303010700,1935,374,2309,0.162,0.838
48303010403,557,221,778,0.284,0.716
48303001501,400,175,575,0.304,0.696
48303002102,408,155,563,0.275,0.725
48303000603,167,54,221,0.244,0.756
48029121803,173,222,395,0.562,0.438
48141003903,525,202,727,0.278,0.722
48141004004,509,240,749,0.32,0.68
48141004103,563,244,807,0.302,0.698
48361021300,303,464,767,0.605,0.395
48029121812,229,335,564,0.594,0.406
48439106511,582,497,1079,0.461,0.539
48439106512,308,241,549,0.439,0.561
48439106513,208,154,362,0.425,0.575
48439106514,535,464,999,0.464,0.536
48121020700,278,383,661,0.579,0.421
48121020900,184,196,380,0.516,0.484
48121021000,375,479,854,0.561,0.439
48121021100,344,519,863,0.601,0.399
48121021301,182,231,413,0.559,0.441
48453001705,307,350,657,0.533,0.467
48453001706,212,222,434,0.512,0.488
48453001707,279,329,608,0.541,0.459
48029130300,391,470,861,0.546,0.454
48029130500,549,602,1151,0.523,0.477
48029130600,680,785,1465,0.536,0.464
48029130700,524,564,1088,0.518,0.482
48029131000,372,366,738,0.496,0.504
48439106515,243,204,447,0.456,0.544
48439106516,303,250,553,0.452,0.548
48439106600,238,161,399,0.404,0.596
48453001712,233,368,601,0.612,0.388
48453001713,213,342,555,0.616,0.384
48453001718,238,267,505,0.529,0.471
48141004314,378,222,600,0.37,0.63
48141004316,371,209,580,0.36,0.64
48141010103,332,153,485,0.315,0.685
48141010307,476,244,720,0.339,0.661
48141002202,556,187,743,0.252,0.748
48141010102,405,180,585,0.308,0.692
48141001107,483,255,738,0.346,0.654
48141000301,407,160,567,0.282,0.718
48141001502,744,414,1158,0.358,0.642
48141010501,1090,390,1480,0.264,0.736
48141001110,213,121,334,0.362,0.638
48141002201,316,109,425,0.256,0.744
48141000900,932,323,1255,0.257,0.743
48141001109,361,193,554,0.348,0.652
48141003601,324,117,441,0.265,0.735
48181000200,414,349,763,0.457,0.543
48141004104,484,218,702,0.311,0.689
48141004105,232,96,328,0.293,0.707
48141004106,428,217,645,0.336,0.664
48141004107,147,85,232,0.366,0.634
48141004202,411,191,602,0.317,0.683
48141004303,608,387,995,0.389,0.611
48121021502,393,399,792,0.504,0.496
48121021505,629,685,1314,0.521,0.479
48121021409,613,413,1026,0.403,0.597
48029121404,259,311,570,0.546,0.454
48029121501,405,503,908,0.554,0.446
48029121504,324,431,755,0.571,0.429
48029121507,267,321,588,0.546,0.454
48029121508,177,238,415,0.573,0.427
48029121601,365,484,849,0.57,0.43
48141010311,372,202,574,0.352,0.648
48151950400,4167,919,5086,0.181,0.819
48151950300,3871,863,4734,0.182,0.818
48173950100,4448,1380,5828,0.237,0.763
48439111404,990,691,1681,0.411,0.589
48053960600,905,501,1406,0.356,0.644
48053960700,2019,941,2960,0.318,0.682
48053960200,932,775,1707,0.454,0.546
48053960300,2203,958,3161,0.303,0.697
48053960500,2761,827,3588,0.23,0.77
48053960100,1953,1721,3674,0.468,0.532
48053960400,1686,933,2619,0.356,0.644
48053960800,1485,841,2326,0.362,0.638
48453001716,170,192,362,0.53,0.47
48453001747,162,254,416,0.611,0.389
48453001823,155,170,325,0.523,0.477
48453002307,162,228,390,0.585,0.415
48453001908,243,329,572,0.575,0.425
48453001719,169,213,382,0.558,0.442
48453001722,168,147,315,0.467,0.533
48453001728,409,639,1048,0.61,0.39
48453001729,217,335,552,0.607,0.393
48409010500,282,460,742,0.62,0.38
48029131504,341,497,838,0.593,0.407
48029980004,153,232,385,0.603,0.397
48439104605,670,498,1168,0.426,0.574
48439104802,602,422,1024,0.412,0.588
48439105001,501,456,957,0.476,0.524
48439111013,766,553,1319,0.419,0.581
48029121604,411,525,936,0.561,0.439
48029121802,426,647,1073,0.603,0.397
48113008400,967,837,1804,0.464,0.536
48113008500,525,463,988,0.469,0.531
48439105006,1073,821,1894,0.433,0.567
48439105201,523,354,877,0.404,0.596
48439105204,240,152,392,0.388,0.612
48439105205,298,185,483,0.383,0.617
48113008604,178,135,313,0.431,0.569
48113008701,368,297,665,0.447,0.553
48113008704,321,246,567,0.434,0.566
48113008801,343,298,641,0.465,0.535
48113009802,322,244,566,0.431,0.569
48439105403,745,669,1414,0.473,0.527
48439105404,680,532,1212,0.439,0.561
48439105405,737,573,1310,0.437,0.563
48185180302,982,882,1864,0.473,0.527
48185180101,1479,893,2372,0.376,0.624
48185180200,1582,1150,2732,0.421,0.579
48185180102,860,752,1612,0.467,0.533
48439105406,435,317,752,0.422,0.578
48439105502,784,601,1385,0.434,0.566
48113009104,197,190,387,0.491,0.509
48321730700,2073,1874,3947,0.475,0.525
48321730400,671,556,1227,0.453,0.547
48321730100,500,447,947,0.472,0.528
48321730501,1812,1923,3735,0.515,0.485
48321730600,1262,1594,2856,0.558,0.442
48439111506,684,523,1207,0.433,0.567
48439111513,389,416,805,0.517,0.483
48439111514,481,467,948,0.493,0.507
48453001746,124,191,315,0.606,0.394
48453001765,820,996,1816,0.548,0.452
48453001737,405,655,1060,0.618,0.382
48453001766,849,745,1594,0.467,0.533
48453002003,163,232,395,0.587,0.413
48453001819,100,121,221,0.548,0.452
48453001714,473,570,1043,0.547,0.453
48453001748,284,443,727,0.609,0.391
48453001901,241,369,610,0.605,0.395
48453002402,262,388,650,0.597,0.403
48393950100,3820,994,4814,0.206,0.794
48453000101,304,503,807,0.623,0.377
48453002313,72,80,152,0.526,0.474
48453000700,381,408,789,0.517,0.483
48453001849,278,257,535,0.48,0.52
48453002421,290,432,722,0.598,0.402
48453001604,383,677,1060,0.639,0.361
48453001910,363,502,865,0.58,0.42
48453002407,378,498,876,0.568,0.432
48453002315,18,21,39,0.538,0.462
48453001308,160,222,382,0.581,0.419
48453001911,130,141,271,0.52,0.48
48453001761,393,442,835,0.529,0.471
48453001755,284,306,590,0.519,0.481
48439105503,807,601,1408,0.427,0.573
48439105505,609,453,1062,0.427,0.573
48439105508,533,373,906,0.412,0.588
48439105510,644,485,1129,0.43,0.57
48439105511,556,414,970,0.427,0.573
48029191816,95,120,215,0.558,0.442
48453001733,101,129,230,0.561,0.439
48453001738,316,481,797,0.604,0.396
48453001741,309,354,663,0.534,0.466
48409010700,1021,1491,2512,0.594,0.406
48409010603,72,118,190,0.621,0.379
48409010601,190,307,497,0.618,0.382
48409011000,1051,1097,2148,0.511,0.489
48409010900,1149,1452,2601,0.558,0.442
48409011300,1108,1189,2297,0.518,0.482
48409011200,790,1120,1910,0.586,0.414
48029121120,198,255,453,0.563,0.437
48439105512,539,386,925,0.417,0.583
48029191303,147,185,332,0.557,0.443
48439105600,643,539,1182,0.456,0.544
48439105701,506,401,907,0.442,0.558
48439105703,369,279,648,0.431,0.569
48439105704,727,561,1288,0.436,0.564
48439105800,389,311,700,0.444,0.556
48057000400,819,915,1734,0.528,0.472
48057000300,347,367,714,0.514,0.486
48057000200,326,462,788,0.586,0.414
48057000100,315,420,735,0.571,0.429
48439111102,809,573,1382,0.415,0.585
48439111202,656,455,1111,0.41,0.59
48439111304,590,431,1021,0.422,0.578
48439106001,809,622,1431,0.435,0.565
48439106002,847,621,1468,0.423,0.577
48439106101,353,238,591,0.403,0.597
48439106102,390,255,645,0.395,0.605
48439106201,405,280,685,0.409,0.591
48439106202,421,261,682,0.383,0.617
48439106300,404,254,658,0.386,0.614
48439106502,372,298,670,0.445,0.555
48439106503,645,494,1139,0.434,0.566
48439106507,193,160,353,0.453,0.547
48439106510,485,423,908,0.466,0.534
48167721700,1156,855,2011,0.425,0.575
48167722100,974,731,1705,0.429,0.571
48167722300,932,773,1705,0.453,0.547
48167722600,167,122,289,0.422,0.578
48167722700,275,233,508,0.459,0.541
48247950200,795,628,1423,0.441,0.559
48139060500,764,665,1429,0.465,0.535
48139060600,1071,891,1962,0.454,0.546
48139061400,1064,771,1835,0.42,0.58
48141010101,558,213,771,0.276,0.724
48141004002,1129,417,1546,0.27,0.73
48141000800,701,240,941,0.255,0.745
48041001301,141,133,274,0.485,0.515
48041001303,394,360,754,0.477,0.523
48041001400,334,304,638,0.476,0.524
48041002015,260,232,492,0.472,0.528
48041001601,494,486,980,0.496,0.504
48041001604,142,126,268,0.47,0.53
48397040401,1424,707,2131,0.332,0.668
48321730202,327,287,614,0.467,0.533
48321730302,234,211,445,0.474,0.526
48321730201,1423,1316,2739,0.48,0.52
48355003002,304,425,729,0.583,0.417
48355003101,295,538,833,0.646,0.354
48061013402,250,284,534,0.532,0.468
48061013500,239,303,542,0.559,0.441
48061013600,319,325,644,0.505,0.495
48061013700,435,467,902,0.518,0.482
48061013801,309,322,631,0.51,0.49
48061013802,309,320,629,0.509,0.491
48061013901,96,120,216,0.556,0.444
48061013903,117,152,269,0.565,0.435
48061014001,417,454,871,0.521,0.479
48061012200,946,1595,2541,0.628,0.372
48061012507,425,657,1082,0.607,0.393
48061013309,110,112,222,0.505,0.495
48469000201,598,488,1086,0.449,0.551
48485010200,723,372,1095,0.34,0.66
48485010600,394,198,592,0.334,0.666
48485010700,484,246,730,0.337,0.663
48469000202,377,299,676,0.442,0.558
48469000301,476,385,861,0.447,0.553
48469000302,264,227,491,0.462,0.538
48469000400,644,538,1182,0.455,0.545
48029121000,424,550,974,0.565,0.435
48469000501,381,292,673,0.434,0.566
48469000601,752,603,1355,0.445,0.555
48469000602,458,357,815,0.438,0.562
48469001501,662,600,1262,0.475,0.525
48029161400,396,660,1056,0.625,0.375
48029190700,329,511,840,0.608,0.392
48029110100,1654,1593,3247,0.491,0.509
48029120800,653,1218,1871,0.651,0.349
48041001804,106,120,226,0.531,0.469
48041002006,91,108,199,0.543,0.457
48041000102,465,514,979,0.525,0.475
48041000103,197,138,335,0.412,0.588
48041002014,271,291,562,0.518,0.482
48041002012,420,408,828,0.493,0.507
48041001701,183,163,346,0.471,0.529
48041001702,167,155,322,0.481,0.519
48041001606,110,102,212,0.481,0.519
48469001601,321,280,601,0.466,0.534
48469001604,258,216,474,0.456,0.544
48469001605,181,148,329,0.45,0.55
48029120701,401,663,1064,0.623,0.377
48029120901,165,208,373,0.558,0.442
48029120702,269,361,630,0.573,0.427
48029120902,364,581,945,0.615,0.385
48029141800,1011,1087,2098,0.518,0.482
48029170102,609,745,1354,0.55,0.45
48029130800,528,662,1190,0.556,0.444
48029190100,450,646,1096,0.589,0.411
48139061300,1072,843,1915,0.44,0.56
48139060207,967,649,1616,0.402,0.598
48139061500,976,701,1677,0.418,0.582
48139061600,1547,1087,2634,0.413,0.587
48139061700,1701,1292,2993,0.432,0.568
48139060900,1405,977,2382,0.41,0.59
48139060204,1068,731,1799,0.406,0.594
48139061000,2454,1673,4127,0.405,0.595
48139060300,458,401,859,0.467,0.533
48139060101,1582,1153,2735,0.422,0.578
48139060400,874,650,1524,0.427,0.573
48139061200,731,562,1293,0.435,0.565
48139061100,1220,980,2200,0.445,0.555
48139060102,1498,1206,2704,0.446,0.554
48139060206,744,493,1237,0.399,0.601
48123970200,1759,1592,3351,0.475,0.525
48123970300,1608,1447,3055,0.474,0.526
48123970100,1732,1532,3264,0.469,0.531
48123970500,936,960,1896,0.506,0.494
48123970400,1211,1084,2295,0.472,0.528
48103950100,4644,1239,5883,0.211,0.789
48127950200,3476,2186,5662,0.386,0.614
48131950100,1790,2208,3998,0.552,0.448
48131950200,2431,2693,5124,0.526,0.474
48141004307,444,251,695,0.361,0.639
48141004309,522,256,778,0.329,0.671
48141004310,366,224,590,0.38,0.62
48041001605,121,114,235,0.485,0.515
48041001803,316,330,646,0.511,0.489
48029121110,157,215,372,0.578,0.422
48029121111,348,446,794,0.562,0.438
48029121112,146,198,344,0.576,0.424
48029110600,677,710,1387,0.512,0.488
48029110700,349,465,814,0.571,0.429
48029110500,392,446,838,0.532,0.468
48029121108,343,444,787,0.564,0.436
48251130215,368,287,655,0.438,0.562
48029120100,1145,1365,2510,0.544,0.456
48029120300,1028,1678,2706,0.62,0.38
48041002007,375,460,835,0.551,0.449
48041002008,376,422,798,0.529,0.471
48431950100,4866,1000,5866,0.17,0.83
48485013800,4478,2644,7122,0.371,0.629
48485012900,505,273,778,0.351,0.649
48029121402,252,368,620,0.594,0.406
48029121403,210,307,517,0.594,0.406
48029121116,206,304,510,0.596,0.404
48029121117,212,302,514,0.588,0.412
48029121300,560,716,1276,0.561,0.439
48029141300,225,239,464,0.515,0.485
48029181303,65,80,145,0.552,0.448
48029182103,463,411,874,0.47,0.53
48029130900,538,592,1130,0.524,0.476
48485011200,466,241,707,0.341,0.659
48485013300,88,45,133,0.338,0.662
48485010100,1382,702,2084,0.337,0.663
48485010400,814,413,1227,0.337,0.663
48485011700,227,129,356,0.362,0.638
48485013502,716,397,1113,0.357,0.643
48485013000,255,133,388,0.343,0.657
48485012800,513,292,805,0.363,0.637
48029181602,241,252,493,0.511,0.489
48029160200,199,356,555,0.641,0.359
48029130200,337,368,705,0.522,0.478
48029190902,324,521,845,0.617,0.383
48029182101,413,432,845,0.511,0.489
48029980002,141,199,340,0.585,0.415
48349970900,1752,972,2724,0.357,0.643
48349970200,2113,1131,3244,0.349,0.651
48349970300,2144,1207,3351,0.36,0.64
48349970800,942,397,1339,0.296,0.704
48349970700,4192,2728,6920,0.394,0.606
48349970500,735,325,1060,0.307,0.693
48349970600,2156,1739,3895,0.446,0.554
48349970100,1568,1162,2730,0.426,0.574
48349970400,2237,1511,3748,0.403,0.597
48349971000,2499,1331,3830,0.348,0.652
48029111000,597,698,1295,0.539,0.461
48029980001,506,725,1231,0.589,0.411
48029181503,169,153,322,0.475,0.525
48029121505,284,405,689,0.588,0.412
48029121118,212,309,521,0.593,0.407
48029120400,836,1206,2042,0.591,0.409
48029120501,604,824,1428,0.577,0.423
48425000200,443,453,896,0.506,0.494
48425000100,2954,2953,5907,0.5,0.5
48029140400,385,490,875,0.56,0.44
48029152000,307,387,694,0.558,0.442
48029151400,338,441,779,0.566,0.434
48029131601,588,813,1401,0.58,0.42
48029160702,302,374,676,0.553,0.447
48029121506,267,364,631,0.577,0.423
48029161200,420,401,821,0.488,0.512
48029162001,558,499,1057,0.472,0.528
48029171100,205,237,442,0.536,0.464
48029171801,210,238,448,0.531,0.469
48029182102,297,367,664,0.553,0.447
48029191804,297,407,704,0.578,0.422
48029151900,415,532,947,0.562,0.438
48029151500,156,208,364,0.571,0.429
48029121205,155,186,341,0.545,0.455
48257050204,529,288,817,0.353,0.647
48029121804,186,236,422,0.559,0.441
48029141900,694,685,1379,0.497,0.503
48029140600,274,320,594,0.539,0.461
48029180202,241,349,590,0.592,0.408
48029152100,1122,1205,2327,0.518,0.482
48439113906,430,450,880,0.511,0.489
48439113910,757,802,1559,0.514,0.486
48029120502,289,487,776,0.628,0.372
48029120600,541,751,1292,0.581,0.419
48029121203,445,622,1067,0.583,0.417
48029121204,151,211,362,0.583,0.417
48029121206,356,467,823,0.567,0.433
48029121115,171,215,386,0.557,0.443
48487950500,1499,261,1760,0.148,0.852
48487950700,3006,501,3507,0.143,0.857
48487950300,5251,2417,7668,0.315,0.685
48487950600,1673,373,2046,0.182,0.818
48039661100,303,238,541,0.44,0.56
48041001900,425,420,845,0.497,0.503
48041002001,507,503,1010,0.498,0.502
48041000202,1729,1441,3170,0.455,0.545
48039663300,361,259,620,0.418,0.582
48361020800,214,268,482,0.556,0.444
48453002110,218,421,639,0.659,0.341
48453002111,305,546,851,0.642,0.358
48439114003,863,615,1478,0.416,0.584
48439122200,354,309,663,0.466,0.534
48439122300,602,454,1056,0.43,0.57
48439122400,431,366,797,0.459,0.541
48439122500,461,357,818,0.436,0.564
48213950200,599,389,988,0.394,0.606
48213950400,904,767,1671,0.459,0.541
48213951000,356,339,695,0.488,0.512
48213951100,723,670,1393,0.481,0.519
48213950800,1078,925,2003,0.462,0.538
48213951400,1431,1165,2596,0.449,0.551
48213950700,558,438,996,0.44,0.56
48213950500,503,500,1003,0.499,0.501
48213951300,893,836,1729,0.484,0.516
48213950300,1385,1151,2536,0.454,0.546
48213950100,940,696,1636,0.425,0.575
48213951200,671,586,1257,0.466,0.534
48067950500,404,362,766,0.473,0.527
48067950100,1098,1096,2194,0.5,0.5
48067950700,1070,1087,2157,0.504,0.496
48067950200,801,739,1540,0.48,0.52
48067950300,344,294,638,0.461,0.539
48067950600,1263,1179,2442,0.483,0.517
48067950400,1039,875,1914,0.457,0.543
48439122600,551,426,977,0.436,0.564
48355006300,996,1378,2374,0.58,0.42
48355006400,1071,1155,2226,0.519,0.481
48061012304,632,550,1182,0.465,0.535
48439114005,602,432,1034,0.418,0.582
48439121601,731,609,1340,0.454,0.546
48439121604,362,301,663,0.454,0.546
48439114006,617,491,1108,0.443,0.557
48231961501,747,366,1113,0.329,0.671
48453002105,191,279,470,0.594,0.406
48453002106,153,275,428,0.643,0.357
48453002107,168,336,504,0.667,0.333
48139060213,1259,1019,2278,0.447,0.553
48139060211,796,605,1401,0.432,0.568
48139060801,868,560,1428,0.392,0.608
48139060702,1210,710,1920,0.37,0.63
48139060214,677,460,1137,0.405,0.595
48139060703,521,334,855,0.391,0.609
48139060802,823,515,1338,0.385,0.615
48139060803,700,410,1110,0.369,0.631
48139060701,594,353,947,0.373,0.627
48139060208,386,327,713,0.459,0.541
48139060212,555,488,1043,0.468,0.532
48139060210,316,263,579,0.454,0.546
48061012402,550,633,1183,0.535,0.465
48061012504,512,832,1344,0.619,0.381
48139060209,541,375,916,0.409,0.591
48497150101,1282,1082,2364,0.458,0.542
48497150402,2209,1598,3807,0.42,0.58
48497150300,1189,1040,2229,0.467,0.533
48497150601,1674,962,2636,0.365,0.635
48497150200,2294,1507,3801,0.396,0.604
48497150603,1302,677,1979,0.342,0.658
48497150401,3156,2732,5888,0.464,0.536
48497150500,1196,745,1941,0.384,0.616
48497150602,1866,1239,3105,0.399,0.601
48497150102,1627,1046,2673,0.391,0.609
48497150403,923,539,1462,0.369,0.631
48047950200,544,1851,2395,0.773,0.227
48047950100,3339,3694,7033,0.525,0.475
48453002109,209,437,646,0.676,0.324
48229950300,8218,2575,10793,0.239,0.761
48453001840,629,546,1175,0.465,0.535
48453000204,410,671,1081,0.621,0.379
48453001740,173,275,448,0.614,0.386
48453001403,132,193,325,0.594,0.406
48453002108,104,165,269,0.613,0.387
48453001768,557,645,1202,0.537,0.463
48061012506,434,487,921,0.529,0.471
48039662900,783,412,1195,0.345,0.655
48039662800,583,731,1314,0.556,0.444
48453001822,170,207,377,0.549,0.451
48453001841,1179,1020,2199,0.464,0.536
48453001845,213,234,447,0.523,0.477
48453001913,237,315,552,0.571,0.429
48453000902,604,1304,1908,0.683,0.317
48453001000,327,793,1120,0.708,0.292
48453001100,977,869,1846,0.471,0.529
48029191806,165,209,374,0.559,0.441
48039662500,669,468,1137,0.412,0.588
48039664100,840,563,1403,0.401,0.599
48039664000,429,263,692,0.38,0.62
48039660100,286,304,590,0.515,0.485
48039662200,485,325,810,0.401,0.599
48039662400,1055,635,1690,0.376,0.624
48039661200,341,275,616,0.446,0.554
48039661000,570,505,1075,0.47,0.53
48039663100,894,619,1513,0.409,0.591
48039662000,1181,853,2034,0.419,0.581
48039664400,1434,1014,2448,0.414,0.586
48063950200,985,622,1607,0.387,0.613
48039660300,407,399,806,0.495,0.505
48453001745,224,226,450,0.502,0.498
48453001749,239,333,572,0.582,0.418
48453001750,264,414,678,0.611,0.389
48453001751,180,189,369,0.512,0.488
48453001752,103,112,215,0.521,0.479
48453001753,184,224,408,0.549,0.451
48029121122,174,230,404,0.569,0.431
48029191413,171,225,396,0.568,0.432
48029191411,85,115,200,0.575,0.425
48039660900,578,520,1098,0.474,0.526
48039661300,633,476,1109,0.429,0.571
48039661400,563,432,995,0.434,0.566
48039662100,1204,748,1952,0.383,0.617
48085031704,396,281,677,0.415,0.585
48085031653,608,819,1427,0.574,0.426
48039662300,536,390,926,0.421,0.579
48039662700,553,465,1018,0.457,0.543
48039663000,684,432,1116,0.387,0.613
48039663200,325,264,589,0.448,0.552
48303001709,399,153,552,0.277,0.723
48303010511,448,186,634,0.293,0.707
48303001708,161,57,218,0.261,0.739
48321730303,329,296,625,0.474,0.526
48029191813,212,313,525,0.596,0.404
48121020306,1145,917,2062,0.445,0.555
48453001754,268,323,591,0.547,0.453
48453001764,730,918,1648,0.557,0.443
48453001769,316,457,773,0.591,0.409
48453001804,261,358,619,0.578,0.422
48453001805,188,197,385,0.512,0.488
48453001806,142,196,338,0.58,0.42
48453001811,182,234,416,0.562,0.438
48453001812,319,330,649,0.508,0.492
48453001813,245,311,556,0.559,0.441
48339692700,418,545,963,0.566,0.434
48339694700,381,334,715,0.467,0.533
48339693700,411,454,865,0.525,0.475
48339690500,340,327,667,0.49,0.51
48339694400,696,751,1447,0.519,0.481
48339693900,649,612,1261,0.485,0.515
48339690300,510,462,972,0.475,0.525
48339692300,569,683,1252,0.546,0.454
48339693000,674,646,1320,0.489,0.511
48339694600,604,678,1282,0.529,0.471
48453001817,229,263,492,0.535,0.465
48453001818,344,420,764,0.55,0.45
48453001820,174,216,390,0.554,0.446
48453001821,235,277,512,0.541,0.459
48453001824,165,189,354,0.534,0.466
48453001828,319,320,639,0.501,0.499
48453001842,607,559,1166,0.479,0.521
48453001843,145,165,310,0.532,0.468
48359950100,3960,1317,5277,0.25,0.75
48339692900,371,467,838,0.557,0.443
48339692200,375,469,844,0.556,0.444
48339694000,470,461,931,0.495,0.505
48339692500,282,340,622,0.547,0.453
48339691400,403,384,787,0.488,0.512
48439111402,456,334,790,0.423,0.577
48339693400,404,417,821,0.508,0.492
48029121813,59,104,163,0.638,0.362
48303010407,734,328,1062,0.309,0.691
48303010510,332,151,483,0.313,0.687
48303010509,267,107,374,0.286,0.714
48303980000,339,63,402,0.157,0.843
48029152202,418,414,832,0.498,0.502
48029161503,129,221,350,0.631,0.369
48029181817,172,137,309,0.443,0.557
48329010107,273,206,479,0.43,0.57
48397040102,602,529,1131,0.468,0.532
48397040402,1711,871,2582,0.337,0.663
48397040504,600,390,990,0.394,0.606
48397040506,1175,668,1843,0.362,0.638
48397040505,1121,646,1767,0.366,0.634
48029191817,455,644,1099,0.586,0.414
48453001200,395,638,1033,0.618,0.382
48453001303,191,325,516,0.63,0.37
48453001304,213,353,566,0.624,0.376
48453001305,452,690,1142,0.604,0.396
48453001307,164,230,394,0.584,0.416
48453001401,184,305,489,0.624,0.376
48453001829,122,138,260,0.531,0.469
48453001832,178,182,360,0.506,0.494
48453001833,375,381,756,0.504,0.496
48453001834,570,607,1177,0.516,0.484
48453001835,176,170,346,0.491,0.509
48453001839,393,364,757,0.481,0.519
48453001844,117,144,261,0.552,0.448
48453001847,388,421,809,0.52,0.48
48453001848,250,250,500,0.5,0.5
48435950300,5735,1221,6956,0.176,0.824
48453001850,137,161,298,0.54,0.46
48453001851,571,450,1021,0.441,0.559
48113018503,59,53,112,0.473,0.527
48481740500,447,326,773,0.422,0.578
48481740800,843,514,1357,0.379,0.621
48481741000,1248,775,2023,0.383,0.617
48481740300,600,429,1029,0.417,0.583
48481741100,1331,868,2199,0.395,0.605
48029170600,382,443,825,0.537,0.463
48029170700,424,546,970,0.563,0.437
48029170800,272,343,615,0.558,0.442
48029170900,428,499,927,0.538,0.462
48029171000,488,571,1059,0.539,0.461
48029171200,225,251,476,0.527,0.473
48441013300,797,301,1098,0.274,0.726
48441013402,897,324,1221,0.265,0.735
48441013500,4789,1691,6480,0.261,0.739
48441011700,918,313,1231,0.254,0.746
48051970200,1483,656,2139,0.307,0.693
48247950400,2818,2547,5365,0.475,0.525
48051970400,1179,878,2057,0.427,0.573
48051970500,2203,828,3031,0.273,0.727
48051970100,417,245,662,0.37,0.63
48051970300,1643,434,2077,0.209,0.791
48029161000,190,268,458,0.585,0.415
48029161100,498,665,1163,0.572,0.428
48029190603,322,498,820,0.607,0.393
48029191405,352,408,760,0.537,0.463
48029131613,169,222,391,0.568,0.432
48029190604,413,677,1090,0.621,0.379
48029181729,135,170,305,0.557,0.443
48029161302,86,121,207,0.585,0.415
48029980100,433,757,1190,0.636,0.364
48029161501,169,301,470,0.64,0.36
48029171700,358,466,824,0.566,0.434
48029171802,290,343,633,0.542,0.458
48029171902,341,444,785,0.566,0.434
48085031645,305,355,660,0.538,0.462
48029171903,342,328,670,0.49,0.51
48453000102,161,216,377,0.573,0.427
48453002005,121,196,317,0.618,0.382
48453002104,185,304,489,0.622,0.378
48259970402,439,385,824,0.467,0.533
48259970401,558,610,1168,0.522,0.478
48259970301,666,546,1212,0.45,0.55
48029131609,281,390,671,0.581,0.419
48005000400,745,798,1543,0.517,0.483
48005001100,520,456,976,0.467,0.533
48029191815,95,130,225,0.578,0.422
48005000700,513,526,1039,0.506,0.494
48005000500,529,593,1122,0.529,0.471
48005000200,441,439,880,0.499,0.501
48005001200,707,740,1447,0.511,0.489
48005000102,361,400,761,0.526,0.474
48005000800,380,413,793,0.521,0.479
48005000600,504,577,1081,0.534,0.466
48005001300,701,746,1447,0.516,0.484
48453000203,58,69,127,0.543,0.457
48453000302,421,784,1205,0.651,0.349
48453000401,341,675,1016,0.664,0.336
48085031646,630,739,1369,0.54,0.46
48085031647,386,428,814,0.526,0.474
48085031648,767,877,1644,0.533,0.467
48085031649,943,647,1590,0.407,0.593
48453001503,436,642,1078,0.596,0.404
48453001402,260,389,649,0.599,0.401
48453001504,302,555,857,0.648,0.352
48453001505,272,501,773,0.648,0.352
48453001501,316,479,795,0.603,0.397
48453001602,232,450,682,0.66,0.34
48453001853,302,254,556,0.457,0.543
48453002002,166,266,432,0.616,0.384
48453002004,47,68,115,0.591,0.409
48113018300,470,824,1294,0.637,0.363
48113018401,283,329,612,0.538,0.462
48113018402,262,386,648,0.596,0.404
48113018403,72,50,122,0.41,0.59
48113018600,253,447,700,0.639,0.361
48113018700,364,651,1015,0.641,0.359
48029161504,111,188,299,0.629,0.371
48029171602,164,292,456,0.64,0.36
48029171919,130,170,300,0.567,0.433
48029171601,132,207,339,0.611,0.389
48029171922,86,94,180,0.522,0.478
48297950100,1988,4015,6003,0.669,0.331
48297950200,269,1011,1280,0.79,0.21
48297950400,619,919,1538,0.598,0.402
48297950300,1617,3067,4684,0.655,0.345
48439111531,391,279,670,0.416,0.584
48439111532,753,557,1310,0.425,0.575
48439111533,504,373,877,0.425,0.575
48439111534,555,405,960,0.422,0.578
48439111538,305,326,631,0.517,0.483
48113018801,435,663,1098,0.604,0.396
48113018802,375,675,1050,0.643,0.357
48113018900,327,544,871,0.625,0.375
48113019004,262,407,669,0.608,0.392
48113019013,126,189,315,0.6,0.4
48029141101,85,109,194,0.562,0.438
48029131401,409,498,907,0.549,0.451
48029141102,115,167,282,0.592,0.408
48029141404,285,348,633,0.55,0.45
48029151302,186,213,399,0.534,0.466
48029160902,309,516,825,0.625,0.375
48471790200,1330,932,2262,0.412,0.588
48471790400,1056,922,1978,0.466,0.534
48471790300,1825,1623,3448,0.471,0.529
48471790500,815,786,1601,0.491,0.509
48479001004,325,195,520,0.375,0.625
48439113803,397,338,735,0.46,0.54
48439113808,541,470,1011,0.465,0.535
48439111545,221,162,383,0.423,0.577
48499950602,1178,794,1972,0.403,0.597
48499950301,1279,639,1918,0.333,0.667
48499950601,2725,1087,3812,0.285,0.715
48429950500,3297,4316,7613,0.567,0.433
48439111546,585,451,1036,0.435,0.565
48439113102,431,402,833,0.483,0.517
48439113104,176,179,355,0.504,0.496
48439113107,298,265,563,0.471,0.529
48113019014,295,458,753,0.608,0.392
48113019016,170,132,302,0.437,0.563
48113019020,213,315,528,0.597,0.403
48113019021,305,470,775,0.606,0.394
48113019023,445,383,828,0.463,0.537
48113019024,479,438,917,0.478,0.522
48113019025,245,356,601,0.592,0.408
48029121606,303,390,693,0.563,0.437
48189950400,998,313,1311,0.239,0.761
48189950300,1460,497,1957,0.254,0.746
48189950900,3395,971,4366,0.222,0.778
48189950500,1237,353,1590,0.222,0.778
48029161304,131,180,311,0.579,0.421
48029161901,218,190,408,0.466,0.534
48029160502,234,371,605,0.613,0.387
48029161802,262,329,591,0.557,0.443
48189950700,2677,644,3321,0.194,0.806
48189950600,4803,1116,5919,0.189,0.811
48189950100,1951,565,2516,0.225,0.775
48189950800,1515,355,1870,0.19,0.81
48225950700,967,811,1778,0.456,0.544
48225950200,329,252,581,0.434,0.566
48225950100,1499,1017,2516,0.404,0.596
48225950500,1320,858,2178,0.394,0.606
48225950600,451,459,910,0.504,0.496
48225950300,550,279,829,0.337,0.663
48329000100,477,442,919,0.481,0.519
48329000401,276,217,493,0.44,0.56
48329000500,809,728,1537,0.474,0.526
48329001100,1173,877,2050,0.428,0.572
48439113212,486,420,906,0.464,0.536
48439113213,646,575,1221,0.471,0.529
48439113214,369,332,701,0.474,0.526
48439113215,317,271,588,0.461,0.539
48329000304,354,269,623,0.432,0.568
48439113216,395,329,724,0.454,0.546
48439113217,439,370,809,0.457,0.543
48329001200,448,427,875,0.488,0.512
48113019026,521,774,1295,0.598,0.402
48113019027,346,415,761,0.545,0.455
48113019028,126,186,312,0.596,0.404
48329001300,537,460,997,0.461,0.539
48143950202,2257,1446,3703,0.39,0.61
48143950201,1261,903,2164,0.417,0.583
48329001400,1151,561,1712,0.328,0.672
48329001500,1251,542,1793,0.302,0.698
48225950400,579,272,851,0.32,0.68
48353950100,3116,792,3908,0.203,0.797
48353950500,6168,1567,7735,0.203,0.797
48353950200,943,323,1266,0.255,0.745
48353950400,1767,606,2373,0.255,0.745
48353950300,1359,460,1819,0.253,0.747
48223950402,771,437,1208,0.362,0.638
48223950401,534,315,849,0.371,0.629
48191950500,5695,1680,7375,0.228,0.772
48329001700,467,303,770,0.394,0.606
48201240902,334,414,748,0.553,0.447
48329010104,363,245,608,0.403,0.597
48415950600,3411,1039,4450,0.233,0.767
48415950300,1375,485,1860,0.261,0.739
48415950200,3847,1011,4858,0.208,0.792
48415950100,4495,1377,5872,0.235,0.765
48439113624,488,345,833,0.414,0.586
48439113625,279,200,479,0.418,0.582
48439113626,405,283,688,0.411,0.589
48113019029,389,573,962,0.596,0.404
48029131506,279,348,627,0.555,0.445
48029130401,456,521,977,0.533,0.467
48029121702,414,577,991,0.582,0.418
48029131402,299,374,673,0.556,0.444
48029121810,93,141,234,0.603,0.397
48439113627,212,132,344,0.384,0.616
48111950100,3669,1946,5615,0.347,0.653
48029131612,141,190,331,0.574,0.426
48085031635,348,352,700,0.503,0.497
48085031636,313,425,738,0.576,0.424
48333950100,2051,1238,3289,0.376,0.624
48329010105,183,129,312,0.413,0.587
48329010108,311,257,568,0.452,0.548
48329010109,1105,397,1502,0.264,0.736
48333950200,1468,892,2360,0.378,0.622
48085031637,334,486,820,0.593,0.407
48085031638,524,474,998,0.475,0.525
48085031639,475,407,882,0.461,0.539
48085031640,631,470,1101,0.427,0.573
48085031641,471,404,875,0.462,0.538
48085031642,374,508,882,0.576,0.424
48439113630,262,174,436,0.399,0.601
48439113703,806,870,1676,0.519,0.481
48113019031,543,732,1275,0.574,0.426
48113019034,119,99,218,0.454,0.546
48113019035,84,60,144,0.417,0.583
48113019036,397,280,677,0.414,0.586
48113019037,420,331,751,0.441,0.559
48113019100,799,553,1352,0.409,0.591
48113019202,260,217,477,0.455,0.545
48113019203,345,265,610,0.434,0.566
48331950401,845,463,1308,0.354,0.646
48217961400,2805,1926,4731,0.407,0.593
48113017003,811,678,1489,0.455,0.545
48113017004,508,476,984,0.484,0.516
48113017101,640,549,1189,0.462,0.538
48113017201,363,340,703,0.484,0.516
48113017202,582,542,1124,0.482,0.518
48113019204,453,380,833,0.456,0.544
48113019205,463,337,800,0.421,0.579
48113019208,298,251,549,0.457,0.543
48245000308,234,192,426,0.451,0.549
48245000307,105,103,208,0.495,0.505
48245000310,230,178,408,0.436,0.564
48043950500,14058,2832,16890,0.168,0.832
48113017301,370,338,708,0.477,0.523
48113017303,546,542,1088,0.498,0.502
48113017305,681,598,1279,0.468,0.532
48329000305,277,249,526,0.473,0.527
48329010112,1305,677,1982,0.342,0.658
48113017306,549,532,1081,0.492,0.508
48113017400,595,598,1193,0.501,0.499
48461950100,3395,1000,4395,0.228,0.772
48461950200,4335,1107,5442,0.203,0.797
48329000302,354,330,684,0.482,0.518
48329000303,435,468,903,0.518,0.482
48329010113,1941,621,2562,0.242,0.758
48329010106,339,234,573,0.408,0.592
48329000200,620,539,1159,0.465,0.535
48329000402,517,480,997,0.481,0.519
48329000600,785,651,1436,0.453,0.547
48113017704,449,433,882,0.491,0.509
48113017804,443,496,939,0.528,0.472
48113017500,490,525,1015,0.517,0.483
48113017805,679,699,1378,0.507,0.493
48113017806,329,364,693,0.525,0.475
48113017602,623,623,1246,0.5,0.5
48113019210,561,366,927,0.395,0.605
48113019211,538,343,881,0.389,0.611
48113019301,196,195,391,0.499,0.501
48113019400,402,357,759,0.47,0.53
48113019501,565,514,1079,0.476,0.524
48039661900,1321,1006,2327,0.432,0.568
48039664300,1243,748,1991,0.376,0.624
48039660400,392,379,771,0.492,0.508
48039662600,364,314,678,0.463,0.537
48039660500,812,783,1595,0.491,0.509
48039664501,735,523,1258,0.416,0.584
48039661700,2166,1682,3848,0.437,0.563
48039661800,1152,833,1985,0.42,0.58
48113017807,358,315,673,0.468,0.532
48113017811,360,269,629,0.428,0.572
48113017812,327,230,557,0.413,0.587
48113017813,357,321,678,0.473,0.527
48113017808,460,343,803,0.427,0.573
48113017814,388,382,770,0.496,0.504
48113017900,394,366,760,0.482,0.518
48113019502,513,411,924,0.445,0.555
48113019600,272,237,509,0.466,0.534
48113019700,394,374,768,0.487,0.513
48113019800,643,498,1141,0.436,0.564
48113019900,405,364,769,0.473,0.527
48113013607,313,240,553,0.434,0.566
48439113623,264,201,465,0.432,0.568
48439122900,557,563,1120,0.503,0.497
48421950200,4169,1487,5656,0.263,0.737
48299970600,730,486,1216,0.4,0.6
48299970100,1478,1113,2591,0.43,0.57
48299970300,1747,1229,2976,0.413,0.587
48299970400,1995,719,2714,0.265,0.735
48299970500,1764,652,2416,0.27,0.73
48299970200,1978,664,2642,0.251,0.749
48189950200,935,271,1206,0.225,0.775
48219950400,1880,352,2232,0.158,0.842
48219950300,850,170,1020,0.167,0.833
48219950100,1315,384,1699,0.226,0.774
48219950600,2418,535,2953,0.181,0.819
48219950500,991,193,1184,0.163,0.837
48219950200,10617,2237,12854,0.174,0.826
48219950700,4236,920,5156,0.178,0.822
48375014300,3882,1234,5116,0.241,0.759
48375013900,408,166,574,0.289,0.711
48375013400,461,198,659,0.3,0.7
48375015300,1078,502,1580,0.318,0.682
48375011800,352,137,489,0.28,0.72
48453001912,283,338,621,0.544,0.456
48113015900,259,245,504,0.486,0.514
48113012604,251,174,425,0.409,0.591
48113013010,234,186,420,0.443,0.557
48113013622,146,108,254,0.425,0.575
48113013621,156,131,287,0.456,0.544
48439110704,731,524,1255,0.418,0.582
48113013623,44,41,85,0.482,0.518
48113014135,267,465,732,0.635,0.365
48113014134,332,485,817,0.594,0.406
48113014133,271,317,588,0.539,0.461
48113014136,352,248,600,0.413,0.587
48113014129,309,281,590,0.476,0.524
48113014311,123,177,300,0.59,0.41
48113016523,975,757,1732,0.437,0.563
48113016625,545,468,1013,0.462,0.538
48113016626,616,524,1140,0.46,0.54
48113016621,519,431,950,0.454,0.546
48113016623,557,426,983,0.433,0.567
48113018142,302,212,514,0.412,0.588
48113018141,288,185,473,0.391,0.609
48113018137,367,491,858,0.572,0.428
48113018138,412,507,919,0.552,0.448
48113018139,391,523,914,0.572,0.428
48113018140,259,311,570,0.546,0.454
48099010101,1362,1058,2420,0.437,0.563
48099010300,560,398,958,0.415,0.585
48099010102,942,1016,1958,0.519,0.481
48099010501,253,346,599,0.578,0.422
48113019043,664,858,1522,0.564,0.436
48113019042,575,647,1222,0.529,0.471
48113019039,759,435,1194,0.364,0.636
48113019038,918,435,1353,0.322,0.678
48113019213,87,64,151,0.424,0.576
48335950200,3411,679,4090,0.166,0.834
48099010502,87,116,203,0.571,0.429
48099010804,352,491,843,0.582,0.418
48099010803,129,162,291,0.557,0.443
48099010201,255,227,482,0.471,0.529
48113013726,140,107,247,0.433,0.567
48113016624,453,373,826,0.452,0.548
48113016622,294,225,519,0.434,0.566
48113007911,24,19,43,0.442,0.558
48305950400,4113,1067,5180,0.206,0.794
48305950600,4453,1171,5624,0.208,0.792
48305950500,1707,462,2169,0.213,0.787
48187210506,674,892,1566,0.57,0.43
48113010903,422,350,772,0.453,0.547
48113001703,250,146,396,0.369,0.631
48113019212,25,18,43,0.419,0.581
48375010100,139,65,204,0.319,0.681
48375010300,311,111,422,0.263,0.737
48375010400,491,206,697,0.296,0.704
48113020300,1137,631,1768,0.357,0.643
48113020500,378,197,575,0.343,0.657
48113020600,600,505,1105,0.457,0.543
48113020700,498,689,1187,0.58,0.42
48113014127,510,492,1002,0.491,0.509
48339691302,203,184,387,0.475,0.525
48339691602,180,167,347,0.481,0.519
48375010200,321,130,451,0.288,0.712
48339693102,214,229,443,0.517,0.483
48339692801,941,954,1895,0.503,0.497
48409011100,248,454,702,0.647,0.353
48491020804,660,531,1191,0.446,0.554
48491021507,720,512,1232,0.416,0.584
48491020603,627,480,1107,0.434,0.566
48491021504,608,505,1113,0.454,0.546
48491020806,277,223,500,0.446,0.554
48061010402,507,1311,1818,0.721,0.279
48035950100,2368,3523,5891,0.598,0.402
48035950400,1844,1901,3745,0.508,0.492
48035950300,1006,1130,2136,0.529,0.471
48035950700,924,912,1836,0.497,0.503
48035950600,657,595,1252,0.475,0.525
48035950200,402,331,733,0.452,0.548
48491021506,233,176,409,0.43,0.57
48491020111,483,243,726,0.335,0.665
48375011500,760,307,1067,0.288,0.712
48375010600,499,212,711,0.298,0.702
48375010700,221,108,329,0.328,0.672
48375011000,659,276,935,0.295,0.705
48491020807,402,354,756,0.468,0.532
48491020315,318,292,610,0.479,0.521
48491020313,562,385,947,0.407,0.593
48491020322,452,335,787,0.426,0.574
48113012301,259,232,491,0.473,0.527
48113012302,242,196,438,0.447,0.553
48375011600,436,183,619,0.296,0.704
48491020312,491,335,826,0.406,0.594
48331950700,1618,542,2160,0.251,0.749
48331950100,1162,852,2014,0.423,0.577
48331950300,1132,636,1768,0.36,0.64
48331950500,897,735,1632,0.45,0.55
48331950800,1216,771,1987,0.388,0.612
48491020327,185,129,314,0.411,0.589
48491020323,85,58,143,0.406,0.594
48491020316,180,182,362,0.503,0.497
48491020410,240,288,528,0.545,0.455
48375011700,541,228,769,0.296,0.704
48375011900,456,190,646,0.294,0.706
48485013401,403,278,681,0.408,0.592
48485980000,71,41,112,0.366,0.634
48375012000,781,318,1099,0.289,0.711
48375012200,914,387,1301,0.297,0.703
48375012600,298,131,429,0.305,0.695
48085031003,518,290,808,0.359,0.641
48085030203,2390,1382,3772,0.366,0.634
48085030302,424,364,788,0.462,0.538
48085030603,698,487,1185,0.411,0.589
48375012800,577,234,811,0.289,0.711
48375013000,391,186,577,0.322,0.678
48375013200,239,109,348,0.313,0.687
48085030529,208,162,370,0.438,0.562
48085031312,606,735,1341,0.548,0.452
48085032010,336,338,674,0.501,0.499
48085031202,709,348,1057,0.329,0.671
48085030201,857,417,1274,0.327,0.673
48085031201,1215,522,1737,0.301,0.699
48085031713,200,130,330,0.394,0.606
48085031004,882,434,1316,0.33,0.67
48085030305,2436,1716,4152,0.413,0.587
48085030303,532,465,997,0.466,0.534
48085030304,613,482,1095,0.44,0.56
48441980000,97,31,128,0.242,0.758
48061010500,337,481,818,0.588,0.412
48375015400,1539,580,2119,0.274,0.726
48375014401,1038,366,1404,0.261,0.739
48375980000,64,22,86,0.256,0.744
48055960400,528,452,980,0.461,0.539
48055960500,1178,1817,2995,0.607,0.393
48055960300,666,532,1198,0.444,0.556
48055960700,1707,1963,3670,0.535,0.465
48055960600,1438,1914,3352,0.571,0.429
48055960200,521,452,973,0.465,0.535
48085030801,373,262,635,0.413,0.587
48085030702,1501,937,2438,0.384,0.616
48085030701,788,441,1229,0.359,0.641
48085030605,469,349,818,0.427,0.573
48085030531,462,316,778,0.406,0.594
48201210500,578,634,1212,0.523,0.477
48265960600,884,607,1491,0.407,0.593
48201221400,214,167,381,0.438,0.562
48201221500,163,154,317,0.486,0.514
48085030525,380,279,659,0.423,0.577
48085030526,634,471,1105,0.426,0.574
48085030516,370,277,647,0.428,0.572
48085030523,723,519,1242,0.418,0.582
48085030511,535,437,972,0.45,0.55
48201210600,475,472,947,0.498,0.502
48201210700,375,454,829,0.548,0.452
48085031411,366,330,696,0.474,0.526
48363000300,1960,2061,4021,0.513,0.487
48363000400,1854,1447,3301,0.438,0.562
48363000200,2614,3104,5718,0.543,0.457
48201221600,465,510,975,0.523,0.477
48363000100,2604,3137,5741,0.546,0.454
48363000500,860,592,1452,0.408,0.592
48201313000,198,195,393,0.496,0.504
48201543100,339,207,546,0.379,0.621
48201420400,225,278,503,0.553,0.447
48201511100,185,157,342,0.459,0.541
48201540200,201,152,353,0.431,0.569
48201231100,507,520,1027,0.506,0.494
48201231300,298,284,582,0.488,0.512
48201231500,146,139,285,0.488,0.512
48201231600,182,178,360,0.494,0.506
48201231700,298,281,579,0.485,0.515
48201251700,1143,544,1687,0.322,0.678
48201340900,183,157,340,0.462,0.538
48201252900,789,631,1420,0.444,0.556
48201230300,187,179,366,0.489,0.511
48201542200,490,526,1016,0.518,0.482
48201423500,116,140,256,0.547,0.453
48201420100,136,126,262,0.481,0.519
48201521500,254,267,521,0.512,0.488
48201241400,291,339,630,0.538,0.462
48201343100,194,250,444,0.563,0.437
48201310400,385,372,757,0.491,0.509
48201320100,133,143,276,0.518,0.482
48201210800,517,491,1008,0.487,0.513
48201210900,220,223,443,0.503,0.497
48265960800,1052,760,1812,0.419,0.581
48265960100,1479,1073,2552,0.42,0.58
48265960200,357,242,599,0.404,0.596
48265960700,1364,1049,2413,0.435,0.565
48085030510,244,221,465,0.475,0.525
48085030508,456,415,871,0.476,0.524
48085030507,155,148,303,0.488,0.512
48085030509,188,129,317,0.407,0.593
48085031711,237,174,411,0.423,0.577
48085031657,610,420,1030,0.408,0.592
48085031660,170,133,303,0.439,0.561
48201231800,223,225,448,0.502,0.498
48201231900,285,287,572,0.502,0.498
48251130500,1799,1088,2887,0.377,0.623
48251130100,1132,726,1858,0.391,0.609
48251130900,1148,800,1948,0.411,0.589
48251130207,1575,1001,2576,0.389,0.611
48251130700,618,432,1050,0.411,0.589
48201232000,350,425,775,0.548,0.452
48201232100,238,193,431,0.448,0.552
48201232200,551,614,1165,0.527,0.473
48201230400,270,259,529,0.49,0.51
48201511400,373,459,832,0.552,0.448
48201250900,337,300,637,0.471,0.529
48363000700,501,333,834,0.399,0.601
48363000800,1472,960,2432,0.395,0.605
48363000900,1067,710,1777,0.4,0.6
48251130204,947,670,1617,0.414,0.586
48251130405,749,454,1203,0.377,0.623
48251130408,1136,680,1816,0.374,0.626
48251130406,637,380,1017,0.374,0.626
48251130302,763,462,1225,0.377,0.623
48251130410,1096,546,1642,0.333,0.667
48201341600,674,644,1318,0.489,0.511
48201340700,315,283,598,0.473,0.527
48201310800,210,174,384,0.453,0.547
48201321300,225,221,446,0.496,0.504
48201233300,823,678,1501,0.452,0.548
48201232500,318,279,597,0.467,0.533
48201232800,182,177,359,0.493,0.507
48085030601,622,417,1039,0.401,0.599
48201454400,233,193,426,0.453,0.547
48351950100,1278,1249,2527,0.494,0.506
48351950300,661,631,1292,0.488,0.512
48351950400,518,389,907,0.429,0.571
48351950200,1655,1602,3257,0.492,0.508
48201240400,586,487,1073,0.454,0.546
48201532200,156,114,270,0.422,0.578
48085032008,400,500,900,0.556,0.444
48085031629,211,260,471,0.552,0.448
48201555200,287,299,586,0.51,0.49
48201431600,208,217,425,0.511,0.489
48201430100,421,389,810,0.48,0.52
48201340400,71,59,130,0.454,0.546
48201310900,456,451,907,0.497,0.503
48085031658,612,413,1025,0.403,0.597
48201252500,1491,1344,2835,0.474,0.526
48201452300,189,157,346,0.454,0.546
48201412500,98,104,202,0.515,0.485
48085031656,673,535,1208,0.443,0.557
48085030505,705,488,1193,0.409,0.591
48085031661,269,281,550,0.511,0.489
48085031408,252,180,432,0.417,0.583
48201531000,204,230,434,0.53,0.47
48201552200,649,501,1150,0.436,0.564
48201341700,251,259,510,0.508,0.492
48201333500,260,271,531,0.51,0.49
48201321800,224,290,514,0.564,0.436
48201311200,284,300,584,0.514,0.486
48201211000,209,190,399,0.476,0.524
48201211100,758,745,1503,0.496,0.504
48201211200,296,272,568,0.479,0.521
48201211300,917,812,1729,0.47,0.53
48201211400,676,599,1275,0.47,0.53
48201221700,319,320,639,0.501,0.499
48201232600,189,168,357,0.471,0.529
48201453200,333,296,629,0.471,0.529
48201413000,165,193,358,0.539,0.461
48201420800,280,300,580,0.517,0.483
48201251800,378,235,613,0.383,0.617
48201252600,1911,1543,3454,0.447,0.553
48201540700,235,272,507,0.536,0.464
48491020403,138,123,261,0.471,0.529
48491020404,186,216,402,0.537,0.463
48443950100,4863,1059,5922,0.179,0.821
48417950300,4010,2371,6381,0.372,0.628
48201232900,280,257,537,0.479,0.521
48201542900,496,408,904,0.451,0.549
48201510700,280,302,582,0.519,0.481
48201252800,1168,768,1936,0.397,0.603
48201553900,468,390,858,0.455,0.545
48201411600,174,182,356,0.511,0.489
48201332900,306,331,637,0.52,0.48
48201253200,1216,754,1970,0.383,0.617
48201221800,263,262,525,0.499,0.501
48055960101,578,850,1428,0.595,0.405
48055960102,839,1044,1883,0.554,0.446
48085030514,481,331,812,0.408,0.592
48085031317,551,627,1178,0.532,0.468
48085031410,547,347,894,0.388,0.612
48085031508,778,453,1231,0.368,0.632
48085031405,1251,925,2176,0.425,0.575
48201221900,268,254,522,0.487,0.513
48201222000,184,168,352,0.477,0.523
48201520400,188,152,340,0.447,0.553
48201350700,168,172,340,0.506,0.494
48201341400,402,355,757,0.469,0.531
48201310600,444,420,864,0.486,0.514
48201254700,348,260,608,0.428,0.572
48201322600,333,405,738,0.549,0.451
48201310700,321,352,673,0.523,0.477
48201231200,208,232,440,0.527,0.473
48201222100,248,237,485,0.489,0.511
48201222200,225,213,438,0.486,0.514
48201222300,187,191,378,0.505,0.495
48201211900,389,434,823,0.527,0.473
48491020405,245,266,511,0.521,0.479
48201422000,168,220,388,0.567,0.433
48491020406,171,174,345,0.504,0.496
48491020503,508,430,938,0.458,0.542
48491020504,564,425,989,0.43,0.57
48491020602,454,344,798,0.431,0.569
48201211500,954,824,1778,0.463,0.537
48201211600,424,404,828,0.488,0.512
48201211700,399,306,705,0.434,0.566
48085032013,596,665,1261,0.527,0.473
48085031654,240,348,588,0.592,0.408
48085031655,450,594,1044,0.569,0.431
48085031807,675,737,1412,0.522,0.478
48085031664,287,427,714,0.598,0.402
48201531200,216,248,464,0.534,0.466
48201342900,290,299,589,0.508,0.492
48201312300,583,540,1123,0.481,0.519
48377950100,6167,1592,7759,0.205,0.795
48377950200,5169,874,6043,0.145,0.855
48085031663,200,276,476,0.58,0.42
48201253100,730,550,1280,0.43,0.57
48201553200,209,163,372,0.438,0.562
48201332000,371,364,735,0.495,0.505
48201350100,673,718,1391,0.516,0.484
48201412600,338,411,749,0.549,0.451
48201452600,294,295,589,0.501,0.499
48201520300,167,174,341,0.51,0.49
48451001400,1454,362,1816,0.199,0.801
48451001301,953,231,1184,0.195,0.805
48451000300,1831,448,2279,0.197,0.803
48439100101,485,408,893,0.457,0.543
48505950301,856,531,1387,0.383,0.617
48201231400,117,121,238,0.508,0.492
48201421300,359,253,612,0.413,0.587
48201252700,628,346,974,0.355,0.645
48201532700,196,200,396,0.505,0.495
48201530200,306,331,637,0.52,0.48
48201530500,207,202,409,0.494,0.506
48201555600,317,239,556,0.43,0.57
48201100000,1800,860,2660,0.323,0.677
48085031100,2230,1100,3330,0.33,0.67
48085030900,1528,857,2385,0.359,0.641
48085031505,685,468,1153,0.406,0.594
48439113705,969,1152,2121,0.543,0.457
48439106509,498,415,913,0.455,0.545
48061010601,516,659,1175,0.561,0.439
48201210100,167,119,286,0.416,0.584
48439110906,714,468,1182,0.396,0.604
48439113403,566,505,1071,0.472,0.528
48451001702,1004,267,1271,0.21,0.79
48451000700,1241,306,1547,0.198,0.802
48451001600,6385,1274,7659,0.166,0.834
48451000400,2065,514,2579,0.199,0.801
48451001102,1759,435,2194,0.198,0.802
48451001000,2034,504,2538,0.199,0.801
48451001704,10100,1734,11834,0.147,0.853
48451001101,1376,337,1713,0.197,0.803
48201220100,227,256,483,0.53,0.47
48201220200,254,298,552,0.54,0.46
48451001200,1318,328,1646,0.199,0.801
48085031712,426,298,724,0.412,0.588
48201222600,235,177,412,0.43,0.57
48201222700,556,433,989,0.438,0.562
48201222800,323,257,580,0.443,0.557
48201222900,315,329,644,0.511,0.489
48201223100,165,133,298,0.446,0.554
48455950400,834,552,1386,0.398,0.602
48455950500,591,387,978,0.396,0.604
48455950200,1017,963,1980,0.486,0.514
48455950300,686,566,1252,0.452,0.548
48403950200,885,859,1744,0.493,0.507
48403950100,639,575,1214,0.474,0.526
48147950401,812,386,1198,0.322,0.678
48147950402,1328,705,2033,0.347,0.653
48147950800,847,548,1395,0.393,0.607
48085031714,232,164,396,0.414,0.586
48085031716,148,107,255,0.42,0.58
48085031715,222,148,370,0.4,0.6
48085031720,129,89,218,0.408,0.592
48085031719,192,136,328,0.415,0.585
48085031806,178,116,294,0.395,0.605
48201220300,209,190,399,0.476,0.524
48201220400,180,148,328,0.451,0.549
48201220500,282,200,482,0.415,0.585
48201220600,140,114,254,0.449,0.551
48439114204,871,484,1355,0.357,0.643
48439102700,706,558,1264,0.441,0.559
48439113811,383,326,709,0.46,0.54
48265960500,803,603,1406,0.429,0.571
48201230100,136,147,283,0.519,0.481
48201230200,572,526,1098,0.479,0.521
48201230500,356,366,722,0.507,0.493
48201230600,231,205,436,0.47,0.53
48201230700,195,154,349,0.441,0.559
48201230800,207,205,412,0.498,0.502
48209010500,478,795,1273,0.625,0.375
48209010901,521,614,1135,0.541,0.459
48209010200,194,286,480,0.596,0.404
48209010902,1040,1108,2148,0.516,0.484
48209010600,788,1112,1900,0.585,0.415
48209010400,639,761,1400,0.544,0.456
48227950100,1917,643,2560,0.251,0.749
48227950600,1019,559,1578,0.354,0.646
48167723700,258,234,492,0.476,0.524
48227950300,933,512,1445,0.354,0.646
48227950700,540,281,821,0.342,0.658
48227950500,1452,735,2187,0.336,0.664
48227950200,1308,647,1955,0.331,0.669
48227950900,3280,965,4245,0.227,0.773
48227950400,1084,577,1661,0.347,0.653
48005000101,520,478,998,0.479,0.521
48005001001,529,584,1113,0.525,0.475
48201210400,486,562,1048,0.536,0.464
48201220700,325,266,591,0.45,0.55
48201220800,233,195,428,0.456,0.544
48005001002,500,574,1074,0.534,0.466
48005000302,373,418,791,0.528,0.472
48201220900,243,200,443,0.451,0.549
48201221000,167,164,331,0.495,0.505
48201221100,195,188,383,0.491,0.509
48201221200,280,286,566,0.505,0.495
48201221300,383,359,742,0.484,0.516
48201230900,636,584,1220,0.479,0.521
48201231000,316,349,665,0.525,0.475
48201251600,410,365,775,0.471,0.529
48201332300,161,185,346,0.535,0.465
48085030528,473,335,808,0.415,0.585
48201254200,442,316,758,0.417,0.583
48201252400,358,392,750,0.523,0.477
48085030527,322,227,549,0.413,0.587
48085030301,613,471,1084,0.435,0.565
48085030404,445,305,750,0.407,0.593
48113001704,210,104,314,0.331,0.669
48113013626,127,55,182,0.302,0.698
48005000901,447,473,920,0.514,0.486
48113010803,664,609,1273,0.478,0.522
48201313400,269,233,502,0.464,0.536
48201313500,361,353,714,0.494,0.506
48201313600,599,592,1191,0.497,0.503
48201313700,262,246,508,0.484,0.516
48201250100,414,409,823,0.497,0.503
48201250200,178,179,357,0.501,0.499
48201250500,299,220,519,0.424,0.576
48201250600,602,620,1222,0.507,0.493
48113010902,507,454,961,0.472,0.528
48167724000,831,500,1331,0.376,0.624
48167724300,1021,677,1698,0.399,0.601
48167724400,916,626,1542,0.406,0.594
48167724500,825,483,1308,0.369,0.631
48167724600,380,224,604,0.371,0.629
48167724700,602,398,1000,0.398,0.602
48167724800,409,314,723,0.434,0.566
48167725000,392,331,723,0.458,0.542
48167725100,453,345,798,0.432,0.568
48439121704,325,289,614,0.471,0.529
48439113002,1440,1363,2803,0.486,0.514
48113011002,356,381,737,0.517,0.483
48201253700,481,359,840,0.427,0.573
48201313800,297,253,550,0.46,0.54
48201313900,449,354,803,0.441,0.559
48167725200,400,276,676,0.408,0.592
48167990000,23,31,54,0.574,0.426
48167723502,727,504,1231,0.409,0.591
48167723501,101,68,169,0.402,0.598
48439106400,620,441,1061,0.416,0.584
48439106004,883,606,1489,0.407,0.593
48439103602,406,261,667,0.391,0.609
48201314300,273,196,469,0.418,0.582
48201320200,364,406,770,0.527,0.473
48113011101,361,343,704,0.487,0.513
48113011103,330,342,672,0.509,0.491
48113011104,345,312,657,0.475,0.525
48201253800,331,287,618,0.464,0.536
48201253900,340,239,579,0.413,0.587
48201254000,274,177,451,0.392,0.608
48201254100,651,459,1110,0.414,0.586
48241950400,604,566,1170,0.484,0.516
48241950800,214,196,410,0.478,0.522
48241950300,366,282,648,0.435,0.565
48241950600,546,297,843,0.352,0.648
48241950500,864,720,1584,0.455,0.545
48241950700,865,754,1619,0.466,0.534
48241950100,1429,1409,2838,0.496,0.504
48241950200,778,579,1357,0.427,0.573
48243950100,4052,1059,5111,0.207,0.793
48367140407,1475,952,2427,0.392,0.608
48367140405,974,507,1481,0.342,0.658
48367140601,1477,1084,2561,0.423,0.577
48367140200,1736,1130,2866,0.394,0.606
48367140602,2188,1539,3727,0.413,0.587
48367140300,1228,838,2066,0.406,0.594
48367140403,1466,660,2126,0.31,0.69
48201254300,654,457,1111,0.411,0.589
48201254400,939,695,1634,0.425,0.575
48201254500,612,431,1043,0.413,0.587
48201254600,605,438,1043,0.42,0.58
48201310100,955,743,1698,0.438,0.562
48201310200,607,530,1137,0.466,0.534
48201310300,567,568,1135,0.5,0.5
48113010101,371,289,660,0.438,0.562
48113010102,311,256,567,0.451,0.549
48201310500,513,483,996,0.485,0.515
48287000100,1220,681,1901,0.358,0.642
48287000300,1329,735,2064,0.356,0.644
48287000400,2789,1386,4175,0.332,0.668
48287000200,1299,686,1985,0.346,0.654
48113010500,518,302,820,0.368,0.632
48113010601,502,386,888,0.435,0.565
48113010602,334,336,670,0.501,0.499
48113020100,1037,729,1766,0.413,0.587
48113020200,779,626,1405,0.446,0.554
48113014128,200,176,376,0.468,0.532
48201250800,561,473,1034,0.457,0.543
48201251000,163,154,317,0.486,0.514
48201251100,469,474,943,0.503,0.497
48201251200,312,319,631,0.506,0.494
48113016522,467,374,841,0.445,0.555
48113018136,421,514,935,0.55,0.45
48113017606,340,340,680,0.5,0.5
48113000606,354,247,601,0.411,0.589
48293970800,1409,801,2210,0.362,0.638
48293970600,1723,906,2629,0.345,0.655
48293970200,1004,681,1685,0.404,0.596
48293970400,495,210,705,0.298,0.702
48293970700,570,384,954,0.403,0.597
48293970100,1363,838,2201,0.381,0.619
48293970300,475,204,679,0.3,0.7
48293970500,631,247,878,0.281,0.719
48201251300,407,357,764,0.467,0.533
48091310100,751,867,1618,0.536,0.464
48127950400,4031,2753,6784,0.406,0.594
48227950802,564,343,907,0.378,0.622
48121020204,1181,1105,2286,0.483,0.517
48121020205,505,423,928,0.456,0.544
48121020115,863,696,1559,0.446,0.554
48121021405,950,1211,2161,0.56,0.44
48121021515,1170,1217,2387,0.51,0.49
48121021527,471,394,865,0.455,0.545
48121020114,602,556,1158,0.48,0.52
48121020506,399,549,948,0.579,0.421
48121020504,287,349,636,0.549,0.451
48121020308,1609,1314,2923,0.45,0.55
48121021304,437,619,1056,0.586,0.414
48121021718,570,618,1188,0.52,0.48
48121021513,351,396,747,0.53,0.47
48121021619,355,354,709,0.499,0.501
48121021720,239,350,589,0.594,0.406
48121021623,259,354,613,0.577,0.423
48121021625,947,1002,1949,0.514,0.486
48121021622,393,550,943,0.583,0.417
48135000800,712,386,1098,0.352,0.648
48113017304,617,577,1194,0.483,0.517
48113018104,811,694,1505,0.461,0.539
48113016803,849,687,1536,0.447,0.553
48113007812,275,268,543,0.494,0.506
48113009803,198,143,341,0.419,0.581
48113013717,134,222,356,0.624,0.376
48113006100,293,303,596,0.508,0.492
48113017604,213,218,431,0.506,0.494
48113003101,750,336,1086,0.309,0.691
48121021636,158,204,362,0.564,0.436
48113003400,757,457,1214,0.376,0.624
48085030519,484,391,875,0.447,0.553
48163950100,5530,5422,10952,0.495,0.505
48163950300,1829,2064,3893,0.53,0.47
48163950200,3712,4116,7828,0.526,0.474
48233950500,6404,1814,8218,0.221,0.779
48233951000,2582,607,3189,0.19,0.81
48233950200,6288,1452,7740,0.188,0.812
48233950700,802,207,1009,0.205,0.795
48113007809,264,218,482,0.452,0.548
48197950100,6371,1984,8355,0.237,0.763
48403950300,1035,1000,2035,0.491,0.509
48113019033,152,236,388,0.608,0.392
48113013618,232,156,388,0.402,0.598
48113009900,1833,1016,2849,0.357,0.643
48113009804,100,60,160,0.375,0.625
48113016516,436,403,839,0.48,0.52
48113009201,490,446,936,0.476,0.524
48113018132,515,351,866,0.405,0.595
48113009103,178,162,340,0.476,0.524
48113019206,517,395,912,0.433,0.567
48113010000,3823,1974,5797,0.341,0.659
48113001504,202,135,337,0.401,0.599
48113014308,85,148,233,0.635,0.365
48171950400,960,605,1565,0.387,0.613
48171950300,1944,1264,3208,0.394,0.606
48171950500,979,612,1591,0.385,0.615
48171950200,1352,971,2323,0.418,0.582
48171950100,1295,911,2206,0.413,0.587
48345950100,3675,1284,4959,0.259,0.741
48347951100,657,571,1228,0.465,0.535
48347950301,888,952,1840,0.517,0.483
48233950600,1055,284,1339,0.212,0.788
48347950302,448,482,930,0.518,0.482
48347950600,204,168,372,0.452,0.548
48347950800,384,307,691,0.444,0.556
48347950900,429,341,770,0.443,0.557
48347950100,512,474,986,0.481,0.519
48347950700,403,364,767,0.475,0.525
48347951000,457,372,829,0.449,0.551
48347950200,880,796,1676,0.475,0.525
48347950400,704,823,1527,0.539,0.461
48283950300,6332,5928,12260,0.484,0.516
48343950300,532,622,1154,0.539,0.461
48343950200,966,1071,2037,0.526,0.474
48343950100,1036,812,1848,0.439,0.561
48113006700,634,516,1150,0.449,0.551
48113006800,421,339,760,0.446,0.554
48113006900,195,132,327,0.404,0.596
48233950800,653,170,823,0.207,0.793
48233950900,1435,356,1791,0.199,0.801
48057000500,1584,2058,3642,0.565,0.435
48221160301,1406,1177,2583,0.456,0.544
48221160204,1246,925,2171,0.426,0.574
48113009701,411,324,735,0.441,0.559
48113013712,141,145,286,0.507,0.493
48113014603,63,118,181,0.652,0.348
48113016618,540,535,1075,0.498,0.502
48113016619,404,355,759,0.468,0.532
48113016703,1036,836,1872,0.447,0.553
48113017702,653,593,1246,0.476,0.524
48113018130,367,257,624,0.412,0.588
48113019032,166,312,478,0.653,0.347
48113000100,468,369,837,0.441,0.559
48113000201,413,332,745,0.446,0.554
48113000202,519,389,908,0.428,0.572
48113000300,448,358,806,0.444,0.556
48113000401,339,197,536,0.368,0.632
48113000404,236,158,394,0.401,0.599
48113000500,484,310,794,0.39,0.61
48113000601,368,248,616,0.403,0.597
48113000603,356,233,589,0.396,0.604
48113000701,279,167,446,0.374,0.626
48113000702,315,178,493,0.361,0.639
48113000800,384,232,616,0.377,0.623
48113000900,323,221,544,0.406,0.594
48113000405,181,103,284,0.363,0.637
48113001001,133,110,243,0.453,0.547
48113001002,229,174,403,0.432,0.568
48355002706,32,48,80,0.6,0.4
48029121906,177,251,428,0.586,0.414
48113001102,237,173,410,0.422,0.578
48113001204,181,137,318,0.431,0.569
48113001301,350,234,584,0.401,0.599
48201554902,326,291,617,0.472,0.528
48201555301,64,59,123,0.48,0.52
48201251502,323,263,586,0.449,0.551
48201252302,280,312,592,0.527,0.473
48201321402,433,516,949,0.544,0.456
48201350802,496,418,914,0.457,0.543
48201343302,154,189,343,0.551,0.449
48201410402,220,261,481,0.543,0.457
48201432001,292,251,543,0.462,0.538
48201421401,84,64,148,0.432,0.568
48201431302,164,165,329,0.502,0.498
48201433001,257,189,446,0.424,0.576
48201452202,145,117,262,0.447,0.553
48113001302,245,186,431,0.432,0.568
48113001400,329,231,560,0.412,0.588
48113001101,416,316,732,0.432,0.568
48113001502,289,196,485,0.404,0.596
48113001503,203,89,292,0.305,0.695
48113001600,550,319,869,0.367,0.633
48113001701,417,212,629,0.337,0.663
48201452802,177,157,334,0.47,0.53
48201542302,232,189,421,0.449,0.551
48201520602,170,185,355,0.521,0.479
48439110901,650,487,1137,0.428,0.572
48439110903,380,284,664,0.428,0.572
48491020108,539,264,803,0.329,0.671
48491020106,343,195,538,0.362,0.638
48491020112,1058,503,1561,0.322,0.678
48491020204,811,436,1247,0.35,0.65
48491020805,857,691,1548,0.446,0.554
48491020803,826,333,1159,0.287,0.713
48491020604,481,270,751,0.36,0.64
48491020508,100,85,185,0.459,0.541
48491020409,242,276,518,0.533,0.467
48491020411,291,370,661,0.56,0.44
48491020107,855,417,1272,0.328,0.672
48491020201,395,258,653,0.395,0.605
48491020105,587,300,887,0.338,0.662
48491020809,466,372,838,0.444,0.556
48491021505,403,314,717,0.438,0.562
48491020706,184,146,330,0.442,0.558
48491020605,452,363,815,0.445,0.555
48491020509,494,373,867,0.43,0.57
48201541003,274,316,590,0.536,0.464
48201554403,312,261,573,0.455,0.545
48201554402,581,498,1079,0.462,0.538
48201543001,468,469,937,0.501,0.499
48201555303,266,242,508,0.476,0.524
48201555302,677,668,1345,0.497,0.503
48201554302,186,149,335,0.445,0.555
48201554502,315,265,580,0.457,0.543
48201554301,501,367,868,0.423,0.577
48201554802,825,757,1582,0.479,0.521
48201555701,354,288,642,0.449,0.551
48201555501,654,400,1054,0.38,0.62
48201555402,1118,759,1877,0.404,0.596
48201251401,55,53,108,0.491,0.509
48201334002,86,76,162,0.469,0.531
48201422401,142,117,259,0.452,0.548
48201550602,108,115,223,0.516,0.484
48201552301,317,243,560,0.434,0.566
48201452801,140,171,311,0.55,0.45
48201324100,1479,1389,2868,0.484,0.516
48201556000,901,607,1508,0.403,0.597
48201334100,1183,1028,2211,0.465,0.535
48201343700,1661,1426,3087,0.462,0.538
48113012209,140,119,259,0.459,0.541
48113016620,686,612,1298,0.471,0.529
48113016701,656,560,1216,0.461,0.539
48367140502,1837,1290,3127,0.413,0.587
48367140411,642,354,996,0.355,0.645
48367140501,1117,689,1806,0.382,0.618
48367140410,438,252,690,0.365,0.635
48367140704,2104,1299,3403,0.382,0.618
48367140705,1723,1250,2973,0.42,0.58
48113016202,374,448,822,0.545,0.455
48113016409,259,268,527,0.509,0.491
48113011001,500,535,1035,0.517,0.483
48113009303,457,418,875,0.478,0.522
48113008603,515,447,962,0.465,0.535
48113016902,1095,777,1872,0.415,0.585
48113011601,288,236,524,0.45,0.55
48113009000,617,531,1148,0.463,0.537
48113019302,441,353,794,0.445,0.555
48113014601,97,166,263,0.631,0.369
48113004600,255,176,431,0.408,0.592
48113007102,612,432,1044,0.414,0.586
48113007820,60,46,106,0.434,0.566
48061980001,105,166,271,0.613,0.387
48061010203,598,1285,1883,0.682,0.318
48061010302,642,2031,2673,0.76,0.24
48061010301,499,1610,2109,0.763,0.237
48061012002,450,1140,1590,0.717,0.283
48061012101,724,1238,1962,0.631,0.369
48061014200,1169,1792,2961,0.605,0.395
48061014400,857,1279,2136,0.599,0.401
48309004103,952,1008,1960,0.514,0.486
48309980000,136,142,278,0.511,0.489
48091310901,497,621,1118,0.555,0.445
48091310902,683,851,1534,0.555,0.445
48091310701,400,537,937,0.573,0.427
48091310606,524,728,1252,0.581,0.419
48091310903,346,450,796,0.565,0.435
48091310603,278,282,560,0.504,0.496
48091310704,552,665,1217,0.546,0.454
48029182105,311,263,574,0.458,0.542
48029182106,589,476,1065,0.447,0.553
48029131615,461,580,1041,0.557,0.443
48029191702,385,541,926,0.584,0.416
48113007201,292,174,466,0.373,0.627
48113007202,163,97,260,0.373,0.627
48113007301,470,320,790,0.405,0.595
48113007302,630,473,1103,0.429,0.571
48029121809,174,244,418,0.584,0.416
48029121811,133,217,350,0.62,0.38
48029121910,218,377,595,0.634,0.366
48029191809,254,358,612,0.585,0.415
48029131802,547,516,1063,0.485,0.515
48029152201,708,680,1388,0.49,0.51
48029162004,468,312,780,0.4,0.6
48029162003,536,462,998,0.463,0.537
48029171502,291,414,705,0.587,0.413
48029171301,223,293,516,0.568,0.432
48029172007,476,490,966,0.507,0.493
48029180603,136,180,316,0.57,0.43
48029191807,470,631,1101,0.573,0.427
48029182002,649,555,1204,0.461,0.539
48029181825,125,109,234,0.466,0.534
48059030200,4085,1499,5584,0.268,0.732
48029182001,241,239,480,0.498,0.502
48029181902,335,339,674,0.503,0.497
48029191811,111,143,254,0.563,0.437
48029121808,82,123,205,0.6,0.4
48029121903,194,287,481,0.597,0.403
48029121907,290,595,885,0.672,0.328
48029131801,287,255,542,0.47,0.53
48029141403,207,270,477,0.566,0.434
48029182003,305,289,594,0.487,0.513
48113003700,566,400,966,0.414,0.586
48113007810,309,235,544,0.432,0.568
48113007903,205,176,381,0.462,0.538
48113007906,254,234,488,0.48,0.52
48505950302,1207,828,2035,0.407,0.593
48505950400,4050,2801,6851,0.409,0.591
48113003800,432,301,733,0.411,0.589
48113003901,272,215,487,0.441,0.559
48113016802,537,438,975,0.449,0.551
48113016704,285,232,517,0.449,0.551
48113016705,511,437,948,0.461,0.539
48453001916,194,229,423,0.541,0.459
48453001783,415,478,893,0.535,0.465
48453001918,229,273,502,0.544,0.456
48453001784,211,230,441,0.522,0.478
48453001780,869,991,1860,0.533,0.467
48453002428,193,291,484,0.601,0.399
48453001775,256,357,613,0.582,0.418
48453001770,351,609,960,0.634,0.366
48453001854,641,506,1147,0.441,0.559
48453002210,318,292,610,0.479,0.521
48453002207,518,587,1105,0.531,0.469
48453002209,1068,899,1967,0.457,0.543
48453001914,263,393,656,0.599,0.401
48453002433,443,509,952,0.535,0.465
48453002429,41,71,112,0.634,0.366
48453002430,137,224,361,0.62,0.38
48453000304,294,508,802,0.633,0.367
48113018105,277,424,701,0.605,0.395
48113018001,514,423,937,0.451,0.549
48113018110,643,949,1592,0.596,0.404
48113018203,413,546,959,0.569,0.431
48113018204,265,495,760,0.651,0.349
48113018206,261,390,651,0.599,0.401
48453002319,18,20,38,0.526,0.474
48453001773,413,458,871,0.526,0.474
48453002426,290,470,760,0.618,0.382
48029121909,348,584,932,0.627,0.373
48259970302,571,485,1056,0.459,0.541
48113017703,237,237,474,0.5,0.5
48113008705,139,112,251,0.446,0.554
48113010701,548,414,962,0.43,0.57
48113013901,285,228,513,0.444,0.556
48029151100,686,999,1685,0.593,0.407
48029160100,422,704,1126,0.625,0.375
48135000500,468,353,821,0.43,0.57
48135002200,3064,871,3935,0.221,0.779
48135002502,508,419,927,0.452,0.548
48135003000,2025,579,2604,0.222,0.778
48029160300,416,594,1010,0.588,0.412
48029160400,359,532,891,0.597,0.403
48029160600,417,473,890,0.531,0.469
48029160701,275,357,632,0.565,0.435
48113003902,539,409,948,0.431,0.569
48113004000,499,397,896,0.443,0.557
48113004100,394,234,628,0.373,0.627
48113004202,222,162,384,0.422,0.578
48113004300,822,554,1376,0.403,0.597
48113004400,374,313,687,0.456,0.544
48245011304,478,535,1013,0.528,0.472
48113004500,676,602,1278,0.471,0.529
48245980000,56,74,130,0.569,0.431
48025950202,1279,1661,2940,0.565,0.435
48025950201,580,854,1434,0.596,0.404
48347950502,166,164,330,0.497,0.503
48347950501,116,94,210,0.448,0.552
48203020302,932,753,1685,0.447,0.553
48203020104,932,898,1830,0.491,0.509
48203020103,639,497,1136,0.438,0.562
48203020604,775,678,1453,0.467,0.533
48203020606,313,257,570,0.451,0.549
48203020501,864,641,1505,0.426,0.574
48203020502,598,544,1142,0.476,0.524
48203020605,281,323,604,0.535,0.465
48203020603,377,439,816,0.538,0.462
48203020301,413,376,789,0.477,0.523
48181000304,1617,1411,3028,0.466,0.534
48181000303,981,1161,2142,0.542,0.458
48181002000,1412,983,2395,0.41,0.59
48073950802,1330,633,1963,0.322,0.678
48073950801,1062,552,1614,0.342,0.658
48391950400,1769,1932,3701,0.522,0.478
48141010335,3868,1029,4897,0.21,0.79
48141010339,836,287,1123,0.256,0.744
48141010347,629,218,847,0.257,0.743
48141010408,286,120,406,0.296,0.704
48165950300,1823,551,2374,0.232,0.768
48165950100,4236,1253,5489,0.228,0.772
48165950200,7244,1892,9136,0.207,0.793
48169950100,5811,1985,7796,0.255,0.745
48175960200,764,732,1496,0.489,0.511
48175960100,958,791,1749,0.452,0.548
48179950300,1220,308,1528,0.202,0.798
48179950700,1166,299,1465,0.204,0.796
48179950600,1297,342,1639,0.209,0.791
48179950500,743,196,939,0.209,0.791
48179950100,10079,2066,12145,0.17,0.83
48439113516,321,257,578,0.445,0.555
48439113607,381,333,714,0.466,0.534
48179950400,1193,307,1500,0.205,0.795
48439113612,577,379,956,0.396,0.604
48439113613,688,483,1171,0.412,0.588
48323950205,491,268,759,0.353,0.647
48323950700,3796,1479,5275,0.28,0.72
48329010114,1857,681,2538,0.268,0.732
48237950500,3158,3468,6626,0.523,0.477
48117950600,6620,2081,8701,0.239,0.761
48129950200,2013,349,2362,0.148,0.852
48129950300,6854,1492,8346,0.179,0.821
48281950500,1231,606,1837,0.33,0.67
48281950400,1233,623,1856,0.336,0.664
48281950100,1277,1704,2981,0.572,0.428
48309002100,372,365,737,0.495,0.505
48141010332,651,296,947,0.313,0.687
48141010334,917,285,1202,0.237,0.763
48141010328,203,118,321,0.368,0.632
48179950800,577,147,724,0.203,0.797
48141004320,197,110,307,0.358,0.642
48141010217,310,179,489,0.366,0.634
48501950200,5727,1412,7139,0.198,0.802
48501950100,3980,1032,5012,0.206,0.794
48199030502,571,578,1149,0.503,0.497
48199030600,247,289,536,0.539,0.461
48199030300,2208,2131,4339,0.491,0.509
48199030200,1617,1456,3073,0.474,0.526
48199030100,1024,974,1998,0.487,0.513
48199030800,968,875,1843,0.475,0.525
48199030501,185,231,416,0.555,0.445
48397040101,593,419,1012,0.414,0.586
48121021900,430,380,810,0.469,0.531
48121021522,143,155,298,0.52,0.48
48121020505,538,880,1418,0.621,0.379
48121021746,349,345,694,0.497,0.503
48121021719,312,300,612,0.49,0.51
48121021747,296,408,704,0.58,0.42
48465950301,584,406,990,0.41,0.59
48465980000,76,49,125,0.392,0.608
48199030700,853,849,1702,0.499,0.501
48199031000,408,448,856,0.523,0.477
48199030400,800,695,1495,0.465,0.535
48199030900,158,171,329,0.52,0.48
48207950300,3750,1574,5324,0.296,0.704
48207950400,3388,1914,5302,0.361,0.639
48195950100,3927,739,4666,0.158,0.842
48195950300,3097,861,3958,0.218,0.782
48141010215,618,308,926,0.333,0.667
48141010213,341,192,533,0.36,0.64
48141010409,285,119,404,0.295,0.705
48141010325,331,220,551,0.399,0.601
48141010324,274,215,489,0.44,0.56
48335950400,4730,1422,6152,0.231,0.769
48131950500,4095,3253,7348,0.443,0.557
48397040503,628,413,1041,0.397,0.603
48121021305,306,484,790,0.613,0.387
48121021202,398,589,987,0.597,0.403
48121021408,570,360,930,0.387,0.613
48121021303,393,536,929,0.577,0.423
48121021618,538,688,1226,0.561,0.439
48141980000,227,84,311,0.27,0.73
48401950502,636,314,950,0.331,0.669
48401950501,809,543,1352,0.402,0.598
48339690900,109,95,204,0.466,0.534
48309002498,538,642,1180,0.544,0.456
48309002501,542,530,1072,0.494,0.506
48309002503,896,953,1849,0.515,0.485
48309002504,444,519,963,0.539,0.461
48325000102,2210,1237,3447,0.359,0.641
48325000402,882,512,1394,0.367,0.633
48325000101,1602,976,2578,0.379,0.621
48325000401,1125,671,1796,0.374,0.626
48423001604,672,428,1100,0.389,0.611
48423001906,571,445,1016,0.438,0.562
48423001908,1165,918,2083,0.441,0.559
48423001907,1158,877,2035,0.431,0.569
48423001905,780,494,1274,0.388,0.612
48423001404,1067,602,1669,0.361,0.639
48423001403,1322,645,1967,0.328,0.672
48423002102,988,640,1628,0.393,0.607
48423002101,957,712,1669,0.427,0.573
48423980000,6,3,9,0.333,0.667
48115950402,1527,304,1831,0.166,0.834
48115950401,1850,399,2249,0.177,0.823
48215020404,491,819,1310,0.625,0.375
48215020504,386,854,1240,0.689,0.311
48215020102,641,1409,2050,0.687,0.313
48215021305,629,1263,1892,0.668,0.332
48215024204,260,664,924,0.719,0.281
48215024110,197,447,644,0.694,0.306
48215021404,440,1031,1471,0.701,0.299
48215023510,434,1045,1479,0.707,0.293
48215023509,435,1123,1558,0.721,0.279
48215021701,488,1098,1586,0.692,0.308
48215022004,356,841,1197,0.703,0.297
48215022204,240,705,945,0.746,0.254
48215021702,515,1271,1786,0.712,0.288
48215023801,318,816,1134,0.72,0.28
48215021806,208,574,782,0.734,0.266
48215022104,291,627,918,0.683,0.317
48215023514,134,384,518,0.741,0.259
48215023515,226,669,895,0.747,0.253
48215022106,407,1034,1441,0.718,0.282
48215022402,261,896,1157,0.774,0.226
48215023103,271,661,932,0.709,0.291
48215023104,400,791,1191,0.664,0.336
48215023512,88,137,225,0.609,0.391
48215024112,697,1386,2083,0.665,0.335
48215023511,299,571,870,0.656,0.344
48215024404,245,540,785,0.688,0.312
48215023513,186,410,596,0.688,0.312
48215021304,528,837,1365,0.613,0.387
48215024205,448,825,1273,0.648,0.352
48215024109,306,573,879,0.652,0.348
48215022103,668,1494,2162,0.691,0.309
48215024111,373,807,1180,0.684,0.316
48465950302,630,445,1075,0.414,0.586
48465950800,7890,1994,9884,0.202,0.798
48013960402,1800,1814,3614,0.502,0.498
48013960202,1219,1013,2232,0.454,0.546
48141010322,401,228,629,0.362,0.638
48141010331,631,375,1006,0.373,0.627
48141010406,324,118,442,0.267,0.733
48141010506,357,128,485,0.264,0.736
48439113618,490,416,906,0.459,0.541
48213950901,904,740,1644,0.45,0.55
48213950602,572,550,1122,0.49,0.51
48213950902,813,563,1376,0.409,0.591
48213950903,402,357,759,0.47,0.53
48213950601,400,358,758,0.472,0.528
48013960401,404,370,774,0.478,0.522
48013960100,3226,3547,6773,0.524,0.476
48013960500,893,1935,2828,0.684,0.316
48013960201,1136,523,1659,0.315,0.685
48013960300,872,552,1424,0.388,0.612
48013960600,2351,4045,6396,0.632,0.368
48141010210,351,205,556,0.369,0.631
48453001774,405,560,965,0.58,0.42
48453001846,202,253,455,0.556,0.444
48121021517,185,183,368,0.497,0.503
48121021745,257,346,603,0.574,0.426
48121021744,160,186,346,0.538,0.462
48121021716,429,552,981,0.563,0.437
48439113619,289,259,548,0.473,0.527
48451001706,729,179,908,0.197,0.803
48121021514,238,260,498,0.522,0.478
48231961000,1198,969,2167,0.447,0.553
48231961700,593,348,941,0.37,0.63
48231960500,857,568,1425,0.399,0.601
48231961200,754,659,1413,0.466,0.534
48231960400,1076,765,1841,0.416,0.584
48231961300,1410,804,2214,0.363,0.637
48231960200,1083,436,1519,0.287,0.713
48231960700,2889,1236,4125,0.3,0.7
48231960600,610,377,987,0.382,0.618
48231960100,892,492,1384,0.355,0.645
48451980000,112,21,133,0.158,0.842
48409010202,246,444,690,0.643,0.357
48409010302,361,618,979,0.631,0.369
48409010301,252,428,680,0.629,0.371
48409010201,353,648,1001,0.647,0.353
48221160100,1476,964,2440,0.395,0.605
48239950300,1965,1236,3201,0.386,0.614
48235950100,5958,1156,7114,0.162,0.838
48239950200,1494,929,2423,0.383,0.617
48239950100,2186,1886,4072,0.463,0.537
48261950100,1995,2036,4031,0.505,0.495
48301950100,2348,771,3119,0.247,0.753
48315950300,779,922,1701,0.542,0.458
48315950400,1096,926,2022,0.458,0.542
48315950200,738,778,1516,0.513,0.487
48315950100,608,560,1168,0.479,0.521
48319950100,1000,504,1504,0.335,0.665
48319950200,3532,2163,5695,0.38,0.62
48339691000,118,95,213,0.446,0.554
48469001503,148,134,282,0.475,0.525
48469001504,455,436,891,0.489,0.511
48037011502,525,616,1141,0.54,0.46
48339691100,147,113,260,0.435,0.565
48339691200,279,254,533,0.477,0.523
48339691500,232,189,421,0.449,0.551
48037011501,566,604,1170,0.516,0.484
48339691700,347,271,618,0.439,0.561
48141010323,258,178,436,0.408,0.592
48141010326,248,169,417,0.405,0.595
48141004319,312,194,506,0.383,0.617
48141010333,766,294,1060,0.277,0.723
48141010345,574,272,846,0.322,0.678
48453001756,235,302,537,0.562,0.438
48453001917,258,324,582,0.557,0.443
48373210204,597,657,1254,0.524,0.476
48373210203,457,341,798,0.427,0.573
48373210302,897,906,1803,0.502,0.498
48373210206,855,500,1355,0.369,0.631
48373210301,784,419,1203,0.348,0.652
48373210205,613,327,940,0.348,0.652
48339691900,289,274,563,0.487,0.513
48339692100,480,516,996,0.518,0.482
48339692400,420,467,887,0.526,0.474
48453000206,176,343,519,0.661,0.339
48453000305,220,426,646,0.659,0.341
48453000205,151,265,416,0.637,0.363
48453000307,175,392,567,0.691,0.309
48453002318,151,218,369,0.591,0.409
48453001919,426,596,1022,0.583,0.417
48121021717,402,538,940,0.572,0.428
48121021715,275,329,604,0.545,0.455
48121021721,184,276,460,0.6,0.4
48309002600,648,782,1430,0.547,0.453
48309002700,464,590,1054,0.56,0.44
48309002800,312,352,664,0.53,0.47
48309003000,313,319,632,0.505,0.495
48309003200,533,505,1038,0.487,0.513
48339690700,382,379,761,0.498,0.502
48339690800,152,126,278,0.453,0.547
48339693200,496,613,1109,0.553,0.447
48339693300,316,383,699,0.548,0.452
48121021516,678,496,1174,0.422,0.578
48121021518,461,356,817,0.436,0.564
48121021519,828,697,1525,0.457,0.543
48121021629,536,825,1361,0.606,0.394
48309003300,298,309,607,0.509,0.491
48339693500,657,661,1318,0.502,0.498
48339693600,173,162,335,0.484,0.516
48339693800,235,230,465,0.495,0.505
48339694500,550,581,1131,0.514,0.486
48339690100,445,459,904,0.508,0.492
48339691800,520,547,1067,0.513,0.487
48365950200,885,732,1617,0.453,0.547
48365950500,335,264,599,0.441,0.559
48365950100,1051,819,1870,0.438,0.562
48365950600,616,549,1165,0.471,0.529
48365950300,470,421,891,0.473,0.527
48365950400,1158,988,2146,0.46,0.54
48187210901,811,1064,1875,0.567,0.433
48187210603,384,398,782,0.509,0.491
48187210902,269,356,625,0.57,0.43
48187210604,628,824,1452,0.567,0.433
48187210504,564,637,1201,0.53,0.47
48187210200,670,584,1254,0.466,0.534
48187210801,536,649,1185,0.548,0.452
48187210100,782,645,1427,0.452,0.548
48187210400,470,442,912,0.485,0.515
48187210705,245,283,528,0.536,0.464
48187210606,301,349,650,0.537,0.463
48387950700,731,808,1539,0.525,0.475
48379950100,1351,690,2041,0.338,0.662
48429950300,977,1026,2003,0.512,0.488
48429950200,835,860,1695,0.507,0.493
48379950200,1269,545,1814,0.3,0.7
48405950300,930,914,1844,0.496,0.504
48405950200,878,353,1231,0.287,0.713
48405950100,1114,895,2009,0.445,0.555
48455950100,854,801,1655,0.484,0.516
48323950204,253,114,367,0.311,0.689
48329980000,159,41,200,0.205,0.795
48187210300,961,853,1814,0.47,0.53
48141010407,447,152,599,0.254,0.746
48141010600,718,341,1059,0.322,0.678
48141004003,472,231,703,0.329,0.671
48453001757,70,83,153,0.542,0.458
48453001781,123,127,250,0.508,0.492
48453001864,226,211,437,0.483,0.517
48329010200,958,522,1480,0.353,0.647
48215020403,542,685,1227,0.558,0.442
48295950200,1854,552,2406,0.229,0.771
48295950300,2824,701,3525,0.199,0.801
48453001772,213,322,535,0.602,0.398
48453001777,206,307,513,0.598,0.402
48453001778,322,349,671,0.52,0.48
48121021621,489,569,1058,0.538,0.462
48121021521,330,241,571,0.422,0.578
48121021723,45,71,116,0.612,0.388
48187210706,397,525,922,0.569,0.431
48121021730,188,351,539,0.651,0.349
48121021740,184,254,438,0.58,0.42
48091310300,554,600,1154,0.52,0.48
48091310401,602,669,1271,0.526,0.474
48091310200,456,648,1104,0.587,0.413
48355005407,89,170,259,0.656,0.344
48355005408,140,279,419,0.666,0.334
48355005410,179,291,470,0.619,0.381
48355002601,177,342,519,0.659,0.341
48447950300,2712,2272,4984,0.456,0.544
48309003703,567,547,1114,0.491,0.509
48309003706,1035,1100,2135,0.515,0.485
48309003707,954,1010,1964,0.514,0.486
48309003708,609,635,1244,0.51,0.49
48201250301,336,297,633,0.469,0.531
48201250302,340,290,630,0.46,0.54
48201251901,704,392,1096,0.358,0.642
48201232302,382,423,805,0.525,0.475
48201232401,609,718,1327,0.541,0.459
48201422302,82,106,188,0.564,0.436
48201422301,215,201,416,0.483,0.517
48201423402,117,106,223,0.475,0.525
48201423302,259,248,507,0.489,0.511
48201423401,205,185,390,0.474,0.526
48201431502,171,174,345,0.504,0.496
48201431301,150,118,268,0.44,0.56
48201431202,248,219,467,0.469,0.531
48201522402,314,230,544,0.423,0.577
48201522401,399,421,820,0.513,0.487
48201552302,289,202,491,0.411,0.589
48201552002,169,164,333,0.492,0.508
48201552101,183,158,341,0.463,0.537
48201552001,330,283,613,0.462,0.538
48201552103,175,140,315,0.444,0.556
48427950702,217,326,543,0.6,0.4
48427950500,503,738,1241,0.595,0.405
48355003602,284,349,633,0.551,0.449
48355005406,725,922,1647,0.56,0.44
48355005802,960,2022,2982,0.678,0.322
48427950701,324,484,808,0.599,0.401
48427950101,1954,1888,3842,0.491,0.509
48427950202,963,971,1934,0.502,0.498
48427950600,439,648,1087,0.596,0.404
48183000402,359,226,585,0.386,0.614
48439102301,856,587,1443,0.407,0.593
48439102302,741,577,1318,0.438,0.562
48439102402,663,537,1200,0.448,0.552
48439102500,871,588,1459,0.403,0.597
48309004201,1304,634,1938,0.327,0.673
48201232402,115,149,264,0.564,0.436
48201232403,119,151,270,0.559,0.441
48201232702,340,265,605,0.438,0.562
48201233101,312,314,626,0.502,0.498
48201233003,154,152,306,0.497,0.503
48029151200,478,579,1057,0.548,0.452
48029151600,221,333,554,0.601,0.399
48029151700,354,457,811,0.564,0.436
48201233102,412,402,814,0.494,0.506
48201431102,125,99,224,0.442,0.558
48201431101,204,166,370,0.449,0.551
48201431402,151,119,270,0.441,0.559
48201433003,203,154,357,0.431,0.569
48201432902,127,120,247,0.486,0.514
48201432901,230,191,421,0.454,0.546
48201432802,297,190,487,0.39,0.61
48201433202,136,160,296,0.541,0.459
48201433201,154,179,333,0.538,0.462
48201433002,81,64,145,0.441,0.559
48201433502,138,113,251,0.45,0.55
48075950200,2978,973,3951,0.246,0.754
48277000402,584,449,1033,0.435,0.565
48277000101,757,428,1185,0.361,0.639
48277000102,814,555,1369,0.405,0.595
48277000401,353,246,599,0.411,0.589
48451001708,2070,405,2475,0.164,0.836
48451001707,680,166,846,0.196,0.804
48451000802,755,184,939,0.196,0.804
48451000801,1225,285,1510,0.189,0.811
48451001800,1642,398,2040,0.195,0.805
48201552102,253,254,507,0.501,0.499
48201554002,237,231,468,0.494,0.506
48201554102,407,361,768,0.47,0.53
48201554101,64,54,118,0.458,0.542
48183980000,44,45,89,0.506,0.494
48439100800,778,612,1390,0.44,0.56
48439100900,498,387,885,0.437,0.563
48439101201,862,665,1527,0.435,0.565
48439101202,1179,856,2035,0.421,0.579
48439101301,641,442,1083,0.408,0.592
48183000401,391,229,620,0.369,0.631
48215020302,702,950,1652,0.575,0.425
48215020301,321,545,866,0.629,0.371
48215020101,457,732,1189,0.616,0.384
48215024108,126,293,419,0.699,0.301
48201554801,500,436,936,0.466,0.534
48201555401,533,386,919,0.42,0.58
48201555702,277,224,501,0.447,0.553
48201232701,125,110,235,0.468,0.532
48201233103,406,397,803,0.494,0.506
48439101401,434,371,805,0.461,0.539
48439101403,444,308,752,0.41,0.59
48439101500,603,442,1045,0.423,0.577
48439101700,822,681,1503,0.453,0.547
48439101402,539,371,910,0.408,0.592
48439113622,544,405,949,0.427,0.573
48309000200,167,167,334,0.5,0.5
48309000300,168,152,320,0.475,0.525
48407200101,1009,758,1767,0.429,0.571
48407200300,1610,1216,2826,0.43,0.57
48309000400,624,580,1204,0.482,0.518
48407200200,1119,754,1873,0.403,0.597
48407200102,1288,1102,2390,0.461,0.539
48439100102,759,643,1402,0.459,0.541
48439100201,644,512,1156,0.443,0.557
48439100202,994,725,1719,0.422,0.578
48439100300,997,784,1781,0.44,0.56
48439100400,750,574,1324,0.434,0.566
48439100501,966,764,1730,0.442,0.558
48439100502,981,729,1710,0.426,0.574
48201233702,232,259,491,0.527,0.473
48201240801,212,231,443,0.521,0.479
48201241101,179,195,374,0.521,0.479
48439102000,901,675,1576,0.428,0.572
48439102100,879,718,1597,0.45,0.55
48439102202,840,647,1487,0.435,0.565
48355002705,359,765,1124,0.681,0.319
48355002704,160,264,424,0.623,0.377
48355005602,470,899,1369,0.657,0.343
48355000800,671,846,1517,0.558,0.442
48355002200,306,532,838,0.635,0.365
48355003202,323,543,866,0.627,0.373
48355000600,590,746,1336,0.558,0.442
48355005601,402,751,1153,0.651,0.349
48355006000,776,1167,1943,0.601,0.399
48355000700,339,432,771,0.56,0.44
48355003500,283,362,645,0.561,0.439
48355005801,160,312,472,0.661,0.339
48355002900,253,384,637,0.603,0.397
48215020204,363,574,937,0.613,0.387
48215980000,18,35,53,0.66,0.34
48215020803,206,504,710,0.71,0.29
48215020726,192,323,515,0.627,0.373
48215020804,155,418,573,0.729,0.271
48201241102,322,366,688,0.532,0.468
48201330302,370,458,828,0.553,0.447
48201331601,254,300,554,0.542,0.458
48201333201,185,197,382,0.516,0.484
48201340301,174,175,349,0.501,0.499
48201342001,260,258,518,0.498,0.502
48201421101,162,131,293,0.447,0.553
48201423301,165,169,334,0.506,0.494
48381020400,350,146,496,0.294,0.706
48381020600,254,147,401,0.367,0.633
48381020200,241,88,329,0.267,0.733
48381020300,207,75,282,0.266,0.734
48201431201,93,76,169,0.45,0.55
48201451001,213,180,393,0.458,0.542
48201451901,238,226,464,0.487,0.513
48201452201,351,258,609,0.424,0.576
48201453401,122,135,257,0.525,0.475
48321730301,715,665,1380,0.482,0.518
48215020205,433,644,1077,0.598,0.402
48215020904,318,651,969,0.672,0.328
48215020903,337,726,1063,0.683,0.317
48215023802,474,1050,1524,0.689,0.311
48309004000,1114,1005,2119,0.474,0.526
48309004202,710,481,1191,0.404,0.596
48309000100,780,766,1546,0.495,0.505
48201453402,359,289,648,0.446,0.554
48201454301,303,270,573,0.471,0.529
48201454501,498,470,968,0.486,0.514
48167725300,495,355,850,0.418,0.582
48167725400,946,698,1644,0.425,0.575
48167725500,318,259,577,0.449,0.551
48167725600,257,157,414,0.379,0.621
48167725800,486,362,848,0.427,0.573
48167725900,235,151,386,0.391,0.609
48223950500,405,240,645,0.372,0.628
48223950800,466,282,748,0.377,0.623
48223950100,743,592,1335,0.443,0.557
48223950600,718,404,1122,0.36,0.64
48223950700,1447,846,2293,0.369,0.631
48223950200,1835,794,2629,0.302,0.698
48223950300,1500,885,2385,0.371,0.629
48201455101,382,277,659,0.42,0.58
48201532501,180,205,385,0.532,0.468
48445950100,10009,2304,12313,0.187,0.813
48445950400,1850,405,2255,0.18,0.82
48061012305,828,864,1692,0.511,0.489
48061012001,442,1083,1525,0.71,0.29
48061012102,615,1076,1691,0.636,0.364
48061980100,15,18,33,0.545,0.455
48061014500,162,232,394,0.589,0.411
48193950100,1008,1197,2205,0.543,0.457
48193950300,927,996,1923,0.518,0.482
48193950200,1139,1404,2543,0.552,0.448
48493000402,734,559,1293,0.432,0.568
48493000500,1078,1243,2321,0.536,0.464
48493000201,647,469,1116,0.42,0.58
48493000600,1389,1333,2722,0.49,0.51
48493000202,1087,830,1917,0.433,0.567
48493000300,1318,948,2266,0.418,0.582
48493000102,699,567,1266,0.448,0.552
48201533901,254,268,522,0.513,0.487
48201534201,110,90,200,0.45,0.55
48201551703,266,274,540,0.507,0.493
48201540501,419,332,751,0.442,0.558
48201540901,127,132,259,0.51,0.49
48061014300,125,200,325,0.615,0.385
48245005500,372,319,691,0.462,0.538
48245005900,168,167,335,0.499,0.501
48245006100,1255,1015,2270,0.447,0.553
48085030515,365,291,656,0.444,0.556
48085030530,387,263,650,0.405,0.595
48085032012,200,291,491,0.593,0.407
48085030506,415,324,739,0.438,0.562
48085031662,424,396,820,0.483,0.517
48111950300,1530,779,2309,0.337,0.663
48119950200,1247,644,1891,0.341,0.659
48119950100,1554,880,2434,0.362,0.638
48015760400,1835,975,2810,0.347,0.653
48015760300,1956,1027,2983,0.344,0.656
48015760100,898,466,1364,0.342,0.658
48015760200,1721,863,2584,0.334,0.666
48085030405,309,255,564,0.452,0.548
48491020314,450,304,754,0.403,0.597
48491021508,664,451,1115,0.404,0.596
48491020114,431,211,642,0.329,0.671
48491021601,592,291,883,0.33,0.67
48491020110,576,310,886,0.35,0.65
48491020319,418,314,732,0.429,0.571
48491020318,687,574,1261,0.455,0.545
48491020317,311,217,528,0.411,0.589
48491020115,255,129,384,0.336,0.664
48491020510,411,371,782,0.474,0.526
48491020202,951,472,1423,0.332,0.668
48491021603,771,380,1151,0.33,0.67
48491020109,371,174,545,0.319,0.681
48491020320,602,432,1034,0.418,0.582
48491020325,173,120,293,0.41,0.59
48491020321,157,110,267,0.412,0.588
48491020328,418,339,757,0.448,0.552
48201233001,159,149,308,0.484,0.516
48439111005,749,544,1293,0.421,0.579
48439111003,540,412,952,0.433,0.567
48439111008,853,577,1430,0.403,0.597
48201233002,161,163,324,0.503,0.497
48201252301,177,210,387,0.543,0.457
48201323801,233,329,562,0.585,0.415
48201323802,247,323,570,0.567,0.433
48201433501,179,133,312,0.426,0.574
48201451403,70,68,138,0.493,0.507
48201451602,348,336,684,0.491,0.509
48201451601,219,219,438,0.5,0.5
48201541001,283,271,554,0.489,0.511
48201542101,377,449,826,0.544,0.456
48113018118,445,640,1085,0.59,0.41
48113018120,193,277,470,0.589,0.411
48141004311,373,232,605,0.383,0.617
48141010207,615,288,903,0.319,0.681
48141010303,324,173,497,0.348,0.652
48141010312,356,197,553,0.356,0.644
48085030504,598,417,1015,0.411,0.589
48085031717,124,93,217,0.429,0.571
48085031507,413,259,672,0.385,0.615
48085031659,203,244,447,0.546,0.454
48085030408,1140,825,1965,0.42,0.58
48085030403,541,470,1011,0.465,0.535
48491020324,432,333,765,0.435,0.565
48245010902,353,364,717,0.508,0.492
48245010500,327,279,606,0.46,0.54
48245000101,276,306,582,0.526,0.474
48491020326,343,300,643,0.467,0.533
48491020311,285,285,570,0.5,0.5
48491020507,121,100,221,0.452,0.548
48121021630,237,324,561,0.578,0.422
48113013615,178,118,296,0.399,0.601
48113013617,426,288,714,0.403,0.597
48113013619,448,326,774,0.421,0.579
48113018121,215,285,500,0.57,0.43
48113018122,1076,1197,2273,0.527,0.473
48113018123,533,662,1195,0.554,0.446
48135003100,1063,639,1702,0.375,0.625
48141010316,340,205,545,0.376,0.624
48141010317,296,168,464,0.362,0.638
48141010401,468,194,662,0.293,0.707
48113018126,824,693,1517,0.457,0.543
48113018127,425,282,707,0.399,0.601
48491020506,514,417,931,0.448,0.552
48491020408,212,211,423,0.499,0.501
48491020505,242,159,401,0.397,0.603
48491020707,265,208,473,0.44,0.56
48245000102,141,168,309,0.544,0.456
48245000302,290,246,536,0.459,0.541
48245006600,579,602,1181,0.51,0.49
48245000400,347,303,650,0.466,0.534
48245000500,226,176,402,0.438,0.562
48245000200,275,238,513,0.464,0.536
48245011102,426,339,765,0.443,0.557
48245011201,1077,1193,2270,0.526,0.474
48439113907,642,801,1443,0.555,0.445
48439113110,301,276,577,0.478,0.522
48439100602,643,532,1175,0.453,0.547
48245011202,6,7,13,0.538,0.462
48245011203,9,13,22,0.591,0.409
48245011302,20,22,42,0.524,0.476
48121021739,105,119,224,0.531,0.469
48121021633,309,433,742,0.584,0.416
48121021628,335,476,811,0.587,0.413
48121021632,454,590,1044,0.565,0.435
48121021635,111,142,253,0.561,0.439
48121021634,80,93,173,0.538,0.462
48113013714,312,500,812,0.616,0.384
48113013715,72,139,211,0.659,0.341
48113013716,388,619,1007,0.615,0.385
48113013718,102,183,285,0.642,0.358
48113013719,472,528,1000,0.528,0.472
48113013720,322,564,886,0.637,0.363
48113018128,302,444,746,0.595,0.405
48113018129,660,488,1148,0.425,0.575
48141001400,365,127,492,0.258,0.742
48453001915,211,322,533,0.604,0.396
48453002425,108,141,249,0.566,0.434
48453001776,143,217,360,0.603,0.397
48453001859,239,175,414,0.423,0.577
48121021638,99,186,285,0.653,0.347
48029191814,154,227,381,0.596,0.404
48029172006,281,309,590,0.524,0.476
48491020203,471,221,692,0.319,0.681
48491020708,440,341,781,0.437,0.563
48491021602,573,211,784,0.269,0.731
48491020808,538,355,893,0.398,0.602
48439111312,482,342,824,0.415,0.585
48439111307,177,128,305,0.42,0.58
48439111406,333,243,576,0.422,0.578
48085031631,247,300,547,0.548,0.452
48463950200,4948,5063,10011,0.506,0.494
48463950100,1870,2317,4187,0.553,0.447
48463950500,775,892,1667,0.535,0.465
48463950400,362,389,751,0.518,0.482
48463950300,988,1198,2186,0.548,0.452
48439111310,641,486,1127,0.431,0.569
48439111547,1037,919,1956,0.47,0.53
48029181822,269,201,470,0.428,0.572
48029181818,189,163,352,0.463,0.537
48029181821,83,61,144,0.424,0.576
48029181724,236,229,465,0.492,0.508
48029181723,200,166,366,0.454,0.546
48227950801,561,353,914,0.386,0.614
48029181726,444,383,827,0.463,0.537
48029181721,143,115,258,0.446,0.554
48439123500,842,600,1442,0.416,0.584
48439123400,1046,588,1634,0.36,0.64
48439111308,206,153,359,0.426,0.574
48439121904,353,364,717,0.508,0.492
48439111553,379,277,656,0.422,0.578
48439122801,167,171,338,0.506,0.494
48439111552,336,237,573,0.414,0.586
48439122001,228,217,445,0.488,0.512
48439122002,220,193,413,0.467,0.533
48439113115,195,187,382,0.49,0.51
48099010503,359,599,958,0.625,0.375
48467950500,948,339,1287,0.263,0.737
48467950700,953,419,1372,0.305,0.695
48467951000,768,525,1293,0.406,0.594
48467950300,1117,485,1602,0.303,0.697
48467950400,895,464,1359,0.341,0.659
48467950800,1203,925,2128,0.435,0.565
48467950900,979,702,1681,0.418,0.582
48467950600,1297,737,2034,0.362,0.638
48467950100,903,652,1555,0.419,0.581
48467950200,635,598,1233,0.485,0.515
48245000700,337,298,635,0.469,0.531
48245001100,383,348,731,0.476,0.524
48245001200,594,477,1071,0.445,0.555
48099010504,248,297,545,0.545,0.455
48027023202,504,782,1286,0.608,0.392
48167724101,470,299,769,0.389,0.611
48245000600,634,504,1138,0.443,0.557
48453001857,632,527,1159,0.455,0.545
48453002434,180,191,371,0.515,0.485
48453002208,278,362,640,0.566,0.434
48019000102,1728,940,2668,0.352,0.648
48029181720,138,119,257,0.463,0.537
48029181826,174,163,337,0.484,0.516
48029181824,177,180,357,0.504,0.496
48029181823,89,99,188,0.527,0.473
48029181901,171,170,341,0.499,0.501
48453002431,513,732,1245,0.588,0.412
48029191202,244,399,643,0.621,0.379
48029191410,44,64,108,0.593,0.407
48029191701,198,277,475,0.583,0.417
48029191201,166,304,470,0.647,0.353
48113013721,309,547,856,0.639,0.361
48113013722,367,384,751,0.511,0.489
48029131100,203,226,429,0.527,0.473
48029191412,88,111,199,0.558,0.442
48029161303,88,142,230,0.617,0.383
48029160901,270,405,675,0.6,0.4
48021950802,399,516,915,0.564,0.436
48021950501,792,794,1586,0.501,0.499
48027020202,971,1112,2083,0.534,0.466
48027980001,189,265,454,0.584,0.416
48091310608,393,300,693,0.433,0.567
48091310605,618,614,1232,0.498,0.502
48029181403,126,91,217,0.419,0.581
48113013725,171,111,282,0.394,0.606
48183001300,534,305,839,0.364,0.636
48183001500,467,361,828,0.436,0.564
48183010302,795,509,1304,0.39,0.61
48183010500,1301,792,2093,0.378,0.622
48183010100,1708,1124,2832,0.397,0.603
48183010700,1823,862,2685,0.321,0.679
48029121119,190,234,424,0.552,0.448
48029121121,108,128,236,0.542,0.458
48029160501,195,244,439,0.556,0.444
48029191005,184,296,480,0.617,0.383
48029171915,61,71,132,0.538,0.462
48029171921,151,181,332,0.545,0.455
48029171923,151,156,307,0.508,0.492
48091310607,494,497,991,0.502,0.498
48091310702,295,314,609,0.516,0.484
48091310802,684,1084,1768,0.613,0.387
48091310502,263,321,584,0.55,0.45
48027020401,648,477,1125,0.424,0.576
48027023203,115,156,271,0.576,0.424
48479001105,63,54,117,0.462,0.538
48479001401,646,405,1051,0.385,0.615
48085031706,263,179,442,0.405,0.595
48453002427,217,350,567,0.617,0.383
48453002317,58,103,161,0.64,0.36
48453001860,173,145,318,0.456,0.544
48453001863,156,141,297,0.475,0.525
48479001811,110,105,215,0.488,0.512
48479001003,134,81,215,0.377,0.623
48479001201,373,231,604,0.382,0.618
48439114206,463,357,820,0.435,0.565
48439113812,415,413,828,0.499,0.501
48439113921,938,1116,2054,0.543,0.457
48121021620,197,166,363,0.457,0.543
48121020106,707,544,1251,0.435,0.565
48121021525,730,770,1500,0.513,0.487
48121021404,887,666,1553,0.429,0.571
48121020309,1936,1918,3854,0.498,0.502
48121020307,1001,864,1865,0.463,0.537
48121021750,267,310,577,0.537,0.463
48121021624,339,416,755,0.551,0.449
48121021742,241,365,606,0.602,0.398
48121020111,304,248,552,0.449,0.551
48121020203,930,1099,2029,0.542,0.458
48121020103,2402,1753,4155,0.422,0.578
48121020107,755,623,1378,0.452,0.548
48309004300,719,940,1659,0.567,0.433
48121021637,235,333,568,0.586,0.414
48439113928,656,553,1209,0.457,0.543
48439113923,293,242,535,0.452,0.548
48479001808,160,153,313,0.489,0.511
48479001722,193,156,349,0.447,0.553
48021950200,1577,1127,2704,0.417,0.583
48021950600,1326,1583,2909,0.544,0.456
48021950100,1404,1180,2584,0.457,0.543
48021950300,1024,1341,2365,0.567,0.433
48121021743,131,173,304,0.569,0.431
48121021727,267,421,688,0.612,0.388
48231961503,930,379,1309,0.29,0.71
48231961502,674,343,1017,0.337,0.663
48479001812,185,186,371,0.501,0.499
48479001814,320,269,589,0.457,0.543
48479001202,346,216,562,0.384,0.616
48479001104,494,318,812,0.392,0.608
48439111016,942,670,1612,0.416,0.584
48439111015,308,206,514,0.401,0.599
48439122802,347,344,691,0.498,0.502
48021950700,1894,2025,3919,0.517,0.483
48021950400,1459,2059,3518,0.585,0.415
48019000200,1645,1673,3318,0.504,0.496
48019000300,1373,767,2140,0.358,0.642
48019000400,790,374,1164,0.321,0.679
48479000109,129,134,263,0.51,0.49
48479000108,114,111,225,0.493,0.507
48479001815,1913,1604,3517,0.456,0.544
48479000602,275,207,482,0.429,0.571
48479001402,235,191,426,0.448,0.552
48479000904,360,223,583,0.383,0.617
48439113631,285,403,688,0.586,0.414
48439113711,157,238,395,0.603,0.397
48157672601,304,332,636,0.522,0.478
48157673001,347,301,648,0.465,0.535
48157673003,556,454,1010,0.45,0.55
48245006300,434,342,776,0.441,0.559
48245006400,278,219,497,0.441,0.559
48245006500,211,162,373,0.434,0.566
48245006700,321,246,567,0.434,0.566
48245006800,219,213,432,0.493,0.507
48245007001,381,463,844,0.549,0.451
48439113922,882,853,1735,0.492,0.508
48439123300,2486,1486,3972,0.374,0.626
48453001785,166,222,388,0.572,0.428
48453001779,921,918,1839,0.499,0.501
48141010212,486,270,756,0.357,0.643
48141004317,157,82,239,0.343,0.657
48141010330,502,318,820,0.388,0.612
48113013803,462,415,877,0.473,0.527
48113013804,347,298,645,0.462,0.538
48113013902,416,381,797,0.478,0.522
48113014001,873,648,1521,0.426,0.574
48113014103,804,664,1468,0.452,0.548
48221160210,618,557,1175,0.474,0.526
48029161902,607,495,1102,0.449,0.551
48091310404,204,242,446,0.543,0.457
48091310503,302,320,622,0.514,0.486
48023950300,2757,2335,5092,0.459,0.541
48039660702,710,735,1445,0.509,0.491
48039660602,1024,1029,2053,0.501,0.499
48039661602,342,247,589,0.419,0.581
48039661601,436,348,784,0.444,0.556
48039660601,540,541,1081,0.5,0.5
48039660701,502,531,1033,0.514,0.486
48091310604,412,262,674,0.389,0.611
48091310403,297,422,719,0.587,0.413
48091310501,342,427,769,0.555,0.445
48135001000,432,368,800,0.46,0.54
48453001771,329,359,688,0.522,0.478
48453000306,137,295,432,0.683,0.317
48453002211,153,146,299,0.488,0.512
48453001782,170,168,338,0.497,0.503
48453002500,241,262,503,0.521,0.479
48453001786,176,197,373,0.528,0.472
48453001858,1170,1095,2265,0.483,0.517
48453001855,1282,1160,2442,0.475,0.525
48453001862,487,435,922,0.472,0.528
48453002212,194,217,411,0.528,0.472
48085031708,360,245,605,0.405,0.595
48453002436,156,171,327,0.523,0.477
48439114207,896,706,1602,0.441,0.559
48439111104,452,301,753,0.4,0.6
48439121905,296,320,616,0.519,0.481
48085031311,727,835,1562,0.535,0.465
48113019040,779,617,1396,0.442,0.558
48113018506,582,374,956,0.391,0.609
48113010904,367,325,692,0.47,0.53
48113014132,169,147,316,0.465,0.535
48039990000,6,10,16,0.625,0.375
48029181725,128,111,239,0.464,0.536
48121020110,459,446,905,0.493,0.507
48121021626,328,288,616,0.468,0.532
48121021737,366,464,830,0.559,0.441
48029161801,201,226,427,0.529,0.471
48029181722,211,161,372,0.433,0.567
48029181730,156,115,271,0.424,0.576
48029131507,149,218,367,0.594,0.406
48029131608,327,429,756,0.567,0.433
48245001301,400,372,772,0.482,0.518
48121021738,491,536,1027,0.522,0.478
48121021735,91,97,188,0.516,0.484
48453002432,139,165,304,0.543,0.457
48453002435,381,437,818,0.534,0.466
48245007002,417,438,855,0.512,0.488
48245005600,252,191,443,0.431,0.569
48479001103,126,120,246,0.488,0.512
48479001716,123,118,241,0.49,0.51
48479001718,100,81,181,0.448,0.552
48479001719,116,99,215,0.46,0.54
48453001861,275,237,512,0.463,0.537
48439113116,226,237,463,0.512,0.488
48439110809,222,161,383,0.42,0.58
48439123100,1626,1129,2755,0.41,0.59
48439101302,1036,680,1716,0.396,0.604
48439110600,546,484,1030,0.47,0.53
48439110806,437,348,785,0.443,0.557
48121021631,366,520,886,0.587,0.413
48479001601,252,222,474,0.468,0.532
48439111103,474,359,833,0.431,0.569
48113018501,681,823,1504,0.547,0.453
48363000600,1002,728,1730,0.421,0.579
48113014113,100,169,269,0.628,0.372
48113014115,212,382,594,0.643,0.357
48113014116,302,244,546,0.447,0.553
48157670102,108,108,216,0.5,0.5
48157670101,253,248,501,0.495,0.505
48157670602,66,63,129,0.488,0.512
48029121701,318,412,730,0.564,0.436
48029121605,139,181,320,0.566,0.434
48029131610,191,242,433,0.559,0.441
48157671002,226,246,472,0.521,0.479
48157670901,445,486,931,0.522,0.478
48157671001,282,261,543,0.481,0.519
48157670902,135,121,256,0.473,0.527
48029131505,120,148,268,0.552,0.448
48029131614,144,175,319,0.549,0.451
48085031709,339,402,741,0.543,0.457
48085031802,720,742,1462,0.508,0.492
48439113707,318,498,816,0.61,0.39
48439110701,829,670,1499,0.447,0.553
48439111536,243,246,489,0.503,0.497
48439121606,695,579,1274,0.454,0.546
48439113911,405,711,1116,0.637,0.363
48439114203,834,502,1336,0.376,0.624
48439104900,269,233,502,0.464,0.536
48141004313,283,124,407,0.305,0.695
48153950500,4840,878,5718,0.154,0.846
48153950600,3768,951,4719,0.202,0.798
48201240802,409,559,968,0.577,0.423
48201340201,424,331,755,0.438,0.562
48201340202,150,158,308,0.513,0.487
48201333902,380,336,716,0.469,0.531
48201333901,129,132,261,0.506,0.494
48201421102,174,140,314,0.446,0.554
48201421202,117,84,201,0.418,0.582
48201421403,130,117,247,0.474,0.526
48201421402,43,37,80,0.462,0.538
48161000300,271,182,453,0.402,0.598
48161000200,343,218,561,0.389,0.611
48161000100,1739,1334,3073,0.434,0.566
48161000700,1234,532,1766,0.301,0.699
48161000900,493,460,953,0.483,0.517
48161000600,1334,996,2330,0.427,0.573
48161000400,1011,651,1662,0.392,0.608
48439113813,364,315,679,0.464,0.536
48439102602,1103,857,1960,0.437,0.563
48439102601,639,455,1094,0.416,0.584
48439113927,1118,1001,2119,0.472,0.528
48439104804,425,292,717,0.407,0.593
48439113919,474,391,865,0.452,0.548
48029121904,99,149,248,0.601,0.399
48029191808,115,189,304,0.622,0.378
48029191810,113,168,281,0.598,0.402
48029191304,388,374,762,0.491,0.509
48029151301,454,648,1102,0.588,0.412
48121021733,73,103,176,0.585,0.415
48121021734,25,33,58,0.569,0.431
48115950500,2075,444,2519,0.176,0.824
48115950600,9846,3094,12940,0.239,0.761
48201423202,231,209,440,0.475,0.525
48201423201,144,164,308,0.532,0.468
48201534203,386,252,638,0.395,0.605
48121021732,57,93,150,0.62,0.38
48121021731,166,300,466,0.644,0.356
48121021729,164,289,453,0.638,0.362
48121021726,231,434,665,0.653,0.347
48201534002,292,257,549,0.468,0.532
48201534003,152,144,296,0.486,0.514
48201543002,590,566,1156,0.49,0.51
48439113924,315,247,562,0.44,0.56
48439113925,285,209,494,0.423,0.577
48439113220,485,408,893,0.457,0.543
48439113221,751,577,1328,0.434,0.566
48245010200,237,228,465,0.49,0.51
48479001720,151,123,274,0.449,0.551
48145000800,2126,1193,3319,0.359,0.641
48439113520,275,228,503,0.453,0.547
48439104803,708,530,1238,0.428,0.572
48439104702,525,386,911,0.424,0.576
48027022104,151,184,335,0.549,0.451
48027020201,523,557,1080,0.516,0.484
48027021904,365,500,865,0.578,0.422
48027022502,373,360,733,0.491,0.509
48027022403,185,212,397,0.534,0.466
48027020402,523,283,806,0.351,0.649
48479001721,82,72,154,0.468,0.532
48221160207,727,629,1356,0.464,0.536
48029192100,568,721,1289,0.559,0.441
48113014119,194,360,554,0.65,0.35
48113014120,224,388,612,0.634,0.366
48113014123,354,534,888,0.601,0.399
48113014126,509,628,1137,0.552,0.448
48157671602,190,189,379,0.499,0.501
48029192300,297,361,658,0.549,0.451
48029191900,1186,1438,2624,0.548,0.452
48029131611,23,33,56,0.589,0.411
48201250401,400,287,687,0.418,0.582
48201451401,158,124,282,0.44,0.56
48201451402,171,145,316,0.459,0.541
48157671601,237,299,536,0.558,0.442
48157671501,431,299,730,0.41,0.59
48157673902,354,576,930,0.619,0.381
48157672001,435,432,867,0.498,0.502
48157672002,170,153,323,0.474,0.526
48157672302,187,261,448,0.583,0.417
48141010203,757,261,1018,0.256,0.744
48201212500,907,788,1695,0.465,0.535
48201324200,570,585,1155,0.506,0.494
48439105902,447,335,782,0.428,0.572
48439105008,640,479,1119,0.428,0.572
48439105007,485,366,851,0.43,0.57
48439105514,408,278,686,0.405,0.595
48439105513,289,205,494,0.415,0.585
48027023106,364,500,864,0.579,0.421
48027022404,320,325,645,0.504,0.496
48027022501,161,225,386,0.583,0.417
48027022105,53,52,105,0.495,0.505
48027023105,262,307,569,0.54,0.46
48221160206,956,692,1648,0.42,0.58
48029171920,183,197,380,0.518,0.482
48029171913,116,139,255,0.545,0.455
48029171916,236,280,516,0.543,0.457
48029180101,480,680,1160,0.586,0.414
48029171302,189,270,459,0.588,0.412
48029171501,129,220,349,0.63,0.37
48029192000,658,790,1448,0.546,0.454
48029192200,410,628,1038,0.605,0.395
48029191506,195,255,450,0.567,0.433
48439113113,154,137,291,0.471,0.529
48439113634,293,317,610,0.52,0.48
48029110900,459,558,1017,0.549,0.451
48029110800,415,509,924,0.551,0.449
48439111018,307,199,506,0.393,0.607
48439111204,548,352,900,0.391,0.609
48439106517,702,525,1227,0.428,0.572
48121020112,175,155,330,0.47,0.53
48121020503,333,529,862,0.614,0.386
48121021201,389,446,835,0.534,0.466
48121021407,480,517,997,0.519,0.481
48121021725,165,256,421,0.608,0.392
48479000107,235,210,445,0.472,0.528
48479000106,286,276,562,0.491,0.509
48439111523,436,459,895,0.513,0.487
48439111524,527,459,986,0.466,0.534
48439111525,767,568,1335,0.425,0.575
48439111526,312,222,534,0.416,0.584
48439111529,256,200,456,0.439,0.561
48439111530,643,477,1120,0.426,0.574
48027023107,251,347,598,0.58,0.42
48027023108,476,745,1221,0.61,0.39
48027023201,148,195,343,0.569,0.431
48027022405,69,67,136,0.493,0.507
48029171914,121,148,269,0.55,0.45
48029171918,338,347,685,0.507,0.493
48029171925,325,312,637,0.49,0.51
48479980000,30,24,54,0.444,0.556
48479000601,421,276,697,0.396,0.604
48479000903,264,159,423,0.376,0.624
48479001807,182,233,415,0.561,0.439
48029181727,85,78,163,0.479,0.521
48029171924,185,187,372,0.503,0.497
48439113632,172,292,464,0.629,0.371
48439113710,137,223,360,0.619,0.381
48439104701,634,436,1070,0.407,0.593
48439113918,363,315,678,0.465,0.535
48439111017,731,550,1281,0.429,0.571
48439121903,233,212,445,0.476,0.524
48029980005,22,21,43,0.488,0.512
48029191812,97,142,239,0.594,0.406
48029171402,254,424,678,0.625,0.375
48029171401,110,194,304,0.638,0.362
48029171917,263,264,527,0.501,0.499
48029172005,221,248,469,0.529,0.471
48157672702,270,214,484,0.442,0.558
48157672301,165,239,404,0.592,0.408
48157673901,418,435,853,0.51,0.49
48157672602,144,159,303,0.525,0.475
48439113114,264,257,521,0.493,0.507
48439113517,154,125,279,0.448,0.552
48439113518,176,161,337,0.478,0.522
48439113709,397,478,875,0.546,0.454
48439113917,502,436,938,0.465,0.535
48157672701,321,330,651,0.507,0.493
48029181731,292,222,514,0.432,0.568
48029181728,428,333,761,0.438,0.562
48029180102,240,312,552,0.565,0.435
48029180604,440,651,1091,0.597,0.403
48029191006,446,787,1233,0.638,0.362
48029181404,127,80,207,0.386,0.614
48113014203,150,260,410,0.634,0.366
48113014204,419,223,642,0.347,0.653
48141010346,377,161,538,0.299,0.701
48141000208,251,136,387,0.351,0.649
48141010216,713,312,1025,0.304,0.696
48141003402,913,361,1274,0.283,0.717
48141010222,562,191,753,0.254,0.746
48141010220,513,187,700,0.267,0.733
48141010211,381,153,534,0.287,0.713
48141000207,357,162,519,0.312,0.688
48141001114,374,192,566,0.339,0.661
48029191505,135,157,292,0.538,0.462
48439111309,505,371,876,0.424,0.576
48439105901,462,344,806,0.427,0.573
48439123200,1452,1139,2591,0.44,0.56
48439123000,859,668,1527,0.437,0.563
48439123600,1086,667,1753,0.38,0.62
48113014302,249,453,702,0.645,0.355
48113014306,210,360,570,0.632,0.368
48113014307,180,315,495,0.636,0.364
48491020113,241,119,360,0.331,0.669
48439111539,628,717,1345,0.533,0.467
48439111540,365,296,661,0.448,0.552
48439111541,309,275,584,0.471,0.529
48439111542,397,351,748,0.469,0.531
48029172004,179,194,373,0.52,0.48
48029181815,252,194,446,0.435,0.565
48029181813,166,150,316,0.475,0.525
48029121905,216,346,562,0.616,0.384
48029172003,220,208,428,0.486,0.514
48439110805,587,491,1078,0.455,0.545
48439111543,395,318,713,0.446,0.554
48439111544,564,433,997,0.434,0.566
48439111550,707,632,1339,0.472,0.528
48439111408,398,281,679,0.414,0.586
48439111551,499,359,858,0.418,0.582
48439111311,360,280,640,0.438,0.562
48029191503,248,246,494,0.498,0.502
48029191504,193,251,444,0.565,0.435
48029181820,244,259,503,0.515,0.485
48121021722,238,341,579,0.589,0.411
48029181814,179,160,339,0.472,0.528
48029181816,147,118,265,0.445,0.555
48029181819,206,190,396,0.48,0.52
48339694302,518,609,1127,0.54,0.46
48339694202,664,696,1360,0.512,0.488
48339694102,322,366,688,0.532,0.468
48339691601,150,127,277,0.458,0.542
48085031804,506,330,836,0.395,0.605
48085031805,671,438,1109,0.395,0.605
48121021749,166,217,383,0.567,0.433
48121021751,178,243,421,0.577,0.423
48121021752,213,277,490,0.565,0.435
48121021520,348,240,588,0.408,0.592
48121021800,406,360,766,0.47,0.53
48437950200,4057,1402,5459,0.257,0.743
48437950300,1246,841,2087,0.403,0.597
48437950400,4232,1154,5386,0.214,0.786
48355002102,339,631,970,0.651,0.349
48355003304,180,309,489,0.632,0.368
48355003102,207,336,543,0.619,0.381
48355005415,135,199,334,0.596,0.404
48355005411,137,241,378,0.638,0.362
48355005413,47,65,112,0.58,0.42
48355006200,881,1195,2076,0.576,0.424
48157673002,495,441,936,0.471,0.529
48157670601,301,307,608,0.505,0.495
48157674501,239,433,672,0.644,0.356
48157674601,344,271,615,0.441,0.559
48157674603,327,296,623,0.475,0.525
48439113108,445,394,839,0.47,0.53
48439113111,361,317,678,0.468,0.532
48141001115,124,53,177,0.299,0.701
48439113112,138,116,254,0.457,0.543
48439113206,466,430,896,0.48,0.52
48439113207,264,244,508,0.48,0.52
48085031309,626,678,1304,0.52,0.48
48085030521,338,334,672,0.497,0.503
48113012500,616,570,1186,0.481,0.519
48141010219,759,399,1158,0.345,0.655
48141010218,432,204,636,0.321,0.679
48141010221,962,346,1308,0.265,0.735
48439110807,1152,828,1980,0.418,0.582
48221160208,1131,809,1940,0.417,0.583
48113012601,307,240,547,0.439,0.561
48113012701,307,271,578,0.469,0.531
48113012702,232,220,452,0.487,0.513
48113012800,808,730,1538,0.475,0.525
48113012900,837,728,1565,0.465,0.535
48113014310,175,331,506,0.654,0.346
48113014403,299,315,614,0.513,0.487
48113014405,201,329,530,0.621,0.379
48113014406,149,283,432,0.655,0.345
48113014407,133,226,359,0.63,0.37
48113014408,172,318,490,0.649,0.351
48113014309,41,63,104,0.606,0.394
48085031652,446,620,1066,0.582,0.418
48085031643,427,491,918,0.535,0.465
48085030520,409,363,772,0.47,0.53
48085030407,385,305,690,0.442,0.558
48085030406,294,252,546,0.462,0.538
48085030518,391,378,769,0.492,0.508
48085030513,942,636,1578,0.403,0.597
48049950700,1329,622,1951,0.319,0.681
48049951300,1767,1122,2889,0.388,0.612
48049950100,1816,933,2749,0.339,0.661
48049950800,1144,565,1709,0.331,0.669
48049951000,732,361,1093,0.33,0.67
48049951100,1134,559,1693,0.33,0.67
48125950300,3392,1362,4754,0.286,0.714
48085032003,313,411,724,0.568,0.432
48085032004,416,557,973,0.572,0.428
48259970100,1927,1505,3432,0.439,0.561
48259970500,573,486,1059,0.459,0.541
48507950100,1635,1668,3303,0.505,0.495
48507950301,2584,1669,4253,0.392,0.608
48507950302,1278,810,2088,0.388,0.612
48507950200,1616,1041,2657,0.392,0.608
48113013620,247,165,412,0.4,0.6
48113006402,627,484,1111,0.436,0.564
48355005416,178,273,451,0.605,0.395
48439113218,336,230,566,0.406,0.594
48439113301,711,660,1371,0.481,0.519
48439113302,554,484,1038,0.466,0.534
48439113405,825,662,1487,0.445,0.555
48439113407,330,269,599,0.449,0.551
48141000600,515,210,725,0.29,0.71
48141010342,2378,858,3236,0.265,0.735
48439113408,606,551,1157,0.476,0.524
48439106518,674,340,1014,0.335,0.665
48439113929,444,511,955,0.535,0.465
48113010804,254,183,437,0.419,0.581
48113010805,283,211,494,0.427,0.573
48113006401,280,229,509,0.45,0.55
48113013105,124,108,232,0.466,0.534
48113013104,74,57,131,0.435,0.565
48113019041,186,143,329,0.435,0.565
48141010338,537,270,807,0.335,0.665
48141010337,294,193,487,0.396,0.604
48113007823,136,84,220,0.382,0.618
48113007822,317,164,481,0.341,0.659
48021950801,235,253,488,0.518,0.482
48113007821,68,47,115,0.409,0.591
48113013011,136,105,241,0.436,0.564
48113007827,46,43,89,0.483,0.517
48113013004,536,526,1062,0.495,0.505
48113013005,281,279,560,0.498,0.502
48113013007,299,277,576,0.481,0.519
48113013008,197,179,376,0.476,0.524
48113013009,255,245,500,0.49,0.51
48113013101,350,305,655,0.466,0.534
48113007826,24,23,47,0.489,0.511
48113007824,190,172,362,0.475,0.525
48113007825,251,215,466,0.461,0.539
48113013102,183,161,344,0.468,0.532
48113014501,226,437,663,0.659,0.341
48113014502,154,312,466,0.67,0.33
48113014602,123,173,296,0.584,0.416
48113014701,146,156,302,0.517,0.483
48113014702,125,180,305,0.59,0.41
48113014901,88,124,212,0.585,0.415
48113014902,250,363,613,0.592,0.408
48113007910,25,22,47,0.468,0.532
48113007909,73,60,133,0.451,0.549
48113013806,709,344,1053,0.327,0.673
48113013727,621,357,978,0.365,0.635
48439113509,366,275,641,0.429,0.571
48439113510,365,281,646,0.435,0.565
48439113511,449,328,777,0.422,0.578
48439113512,467,371,838,0.443,0.557
48439113513,451,315,766,0.411,0.589
48113014205,216,248,464,0.534,0.466
48113014312,501,682,1183,0.577,0.423
48113014137,491,379,870,0.436,0.564
48113016412,368,385,753,0.511,0.489
48085032009,697,452,1149,0.393,0.607
48141010336,361,215,576,0.373,0.627
48141004318,582,331,913,0.363,0.637
48141010405,525,192,717,0.268,0.732
48141010340,378,158,536,0.295,0.705
48113016413,409,426,835,0.51,0.49
48441013404,840,325,1165,0.279,0.721
48025950600,694,1018,1712,0.595,0.405
48025950300,1022,1087,2109,0.515,0.485
48025950100,772,1079,1851,0.583,0.417
48025950400,581,619,1200,0.516,0.484
48113013200,718,491,1209,0.406,0.594
48113013300,309,258,567,0.455,0.545
48113013400,273,229,502,0.456,0.544
48113013500,315,301,616,0.489,0.511
48113013605,461,356,817,0.436,0.564
48113013606,463,372,835,0.446,0.554
48113013608,453,351,804,0.437,0.563
48113015000,256,420,676,0.621,0.379
48113015100,211,416,627,0.663,0.337
48113015202,116,263,379,0.694,0.306
48113015204,265,418,683,0.612,0.388
48113015205,100,167,267,0.625,0.375
48113015206,131,283,414,0.684,0.316
48113015303,289,254,543,0.468,0.532
48113015305,139,249,388,0.642,0.358
48041000201,291,323,614,0.526,0.474
48439105507,777,577,1354,0.426,0.574
48439110907,390,283,673,0.421,0.579
48439113912,243,353,596,0.592,0.408
48439111011,662,495,1157,0.428,0.572
48045950200,3850,1149,4999,0.23,0.77
48439113001,889,795,1684,0.472,0.528
48113009101,479,422,901,0.468,0.532
48439110905,507,357,864,0.413,0.587
48439121610,260,199,459,0.434,0.566
48439111405,596,365,961,0.38,0.62
48439100601,975,771,1746,0.442,0.558
48439113908,169,241,410,0.588,0.412
48439100700,434,358,792,0.452,0.548
48439104502,697,451,1148,0.393,0.607
48439111306,563,415,978,0.424,0.576
48439111537,405,436,841,0.518,0.482
48439113210,487,408,895,0.456,0.544
48113009401,379,277,656,0.422,0.578
48113009402,286,223,509,0.438,0.562
48113009500,371,310,681,0.455,0.545
48209010100,274,625,899,0.695,0.305
48209010302,230,402,632,0.636,0.364
48001950901,683,611,1294,0.472,0.528
48041000101,883,816,1699,0.48,0.52
48001951100,1012,933,1945,0.48,0.52
48041002009,326,376,702,0.536,0.464
48041002013,570,636,1206,0.527,0.473
48041002011,1001,778,1779,0.437,0.563
48041980000,44,50,94,0.532,0.468
48005000902,183,188,371,0.507,0.493
48005000301,352,367,719,0.51,0.49
48187210804,725,766,1491,0.514,0.486
48187210507,377,466,843,0.553,0.447
48187210803,408,486,894,0.544,0.456
48187210714,462,639,1101,0.58,0.42
48187210505,210,241,451,0.534,0.466
48063950102,896,699,1595,0.438,0.562
48063950101,509,431,940,0.459,0.541
48109950300,4973,1749,6722,0.26,0.74
48281950302,558,542,1100,0.493,0.507
48439111010,930,542,1472,0.368,0.632
48439111301,846,548,1394,0.393,0.607
48439111012,545,415,960,0.432,0.568
48439105203,261,185,446,0.415,0.585
48439113610,1077,853,1930,0.442,0.558
48439113909,252,350,602,0.581,0.419
48457950200,1396,1337,2733,0.489,0.511
48439110204,845,745,1590,0.469,0.531
48439110301,651,486,1137,0.427,0.573
48439110302,461,377,838,0.45,0.55
48439110402,741,627,1368,0.458,0.542
48439110500,864,768,1632,0.471,0.529
48495950200,963,185,1148,0.161,0.839
48495950300,1159,210,1369,0.153,0.847
48495950400,3764,1177,4941,0.238,0.762
48201533701,258,198,456,0.434,0.566
48201223002,78,74,152,0.487,0.513
48201980100,617,473,1090,0.434,0.566
48201250402,810,663,1473,0.45,0.55
48201232301,465,446,911,0.49,0.51
48469001606,836,785,1621,0.484,0.516
48469980000,8,6,14,0.429,0.571
48381021102,119,42,161,0.261,0.739
48381021703,620,310,930,0.333,0.667
48381021704,1180,443,1623,0.273,0.727
48479001806,89,98,187,0.524,0.476
48479001813,1889,1681,3570,0.471,0.529
48479001810,237,219,456,0.48,0.52
48479001818,123,152,275,0.553,0.447
48479001717,283,245,528,0.464,0.536
48479001710,3410,2029,5439,0.373,0.627
48479000105,295,238,533,0.447,0.553
48479001715,183,155,338,0.459,0.541
48479001712,226,180,406,0.443,0.557
48479001711,488,397,885,0.449,0.551
48479001602,134,107,241,0.444,0.556
48479001816,153,137,290,0.472,0.528
48479001713,588,449,1037,0.433,0.567
48479001809,142,188,330,0.57,0.43
48479001817,147,169,316,0.535,0.465
48479001714,313,307,620,0.495,0.505
48339690202,543,473,1016,0.466,0.534
48339690402,744,592,1336,0.443,0.557
48339690201,672,663,1335,0.497,0.503
48339690401,240,235,475,0.495,0.505
48339690602,851,721,1572,0.459,0.541
48339691301,153,129,282,0.457,0.543
48339692002,240,370,610,0.607,0.393
48339692001,805,1052,1857,0.567,0.433
48339692602,299,367,666,0.551,0.449
48339693101,494,540,1034,0.522,0.478
48339692802,548,764,1312,0.582,0.418
48339694301,779,904,1683,0.537,0.463
48339694201,579,560,1139,0.492,0.508
48339694101,1228,1121,2349,0.477,0.523
48339690601,762,634,1396,0.454,0.546
48339692601,106,154,260,0.592,0.408
48439114104,1039,611,1650,0.37,0.63
48439114103,2385,1605,3990,0.402,0.598
48439113816,267,360,627,0.574,0.426
48439113815,305,262,567,0.462,0.538
48439110808,669,436,1105,0.395,0.605
48439113519,441,369,810,0.456,0.544
48439114008,967,773,1740,0.444,0.556
48439113926,1799,1257,3056,0.411,0.589
48439980000,1666,782,2448,0.319,0.681
48439113920,392,334,726,0.46,0.54
48439111407,284,201,485,0.414,0.586
48439111409,371,282,653,0.432,0.568
48439111548,605,538,1143,0.471,0.529
48439121906,183,204,387,0.527,0.473
48439113814,300,249,549,0.454,0.546
48439113633,261,232,493,0.471,0.529
48439114007,1064,883,1947,0.454,0.546
48439111203,552,359,911,0.394,0.606
48439111549,777,620,1397,0.444,0.556
48439111314,303,220,523,0.421,0.579
48439111313,548,414,962,0.43,0.57
48433950300,3639,1638,5277,0.31,0.69
48167720302,363,374,737,0.507,0.493
48471790103,886,653,1539,0.424,0.576
48471790101,1046,760,1806,0.421,0.579
48471790102,467,345,812,0.425,0.575
48113012603,224,177,401,0.441,0.559
48113020400,2385,1309,3694,0.354,0.646
48039663800,234,149,383,0.389,0.611
48039663900,209,129,338,0.382,0.618
48039664200,2505,1745,4250,0.411,0.589
48309001600,1254,1146,2400,0.478,0.522
48309001900,447,445,892,0.499,0.501
48085030604,150,99,249,0.398,0.602
48085030202,1247,897,2144,0.418,0.582
48085031407,838,504,1342,0.376,0.624
48085031406,1326,970,2296,0.422,0.578
48085030802,977,625,1602,0.39,0.61
48085030517,628,476,1104,0.431,0.569
48085030522,480,374,854,0.438,0.562
48085031313,919,1109,2028,0.547,0.453
48085031316,553,501,1054,0.475,0.525
48085031314,358,323,681,0.474,0.526
48085031310,812,833,1645,0.506,0.494
48085031308,599,575,1174,0.49,0.51
48085031315,811,997,1808,0.551,0.449
48085032011,486,344,830,0.414,0.586
48085031409,694,630,1324,0.476,0.524
48085031718,361,282,643,0.439,0.561
48085030524,162,148,310,0.477,0.523
48113000406,883,578,1461,0.396,0.604
48113016520,498,404,902,0.448,0.552
48113014206,415,259,674,0.384,0.616
48113014138,267,190,457,0.416,0.584
48113014130,368,346,714,0.485,0.515
48113007912,105,64,169,0.379,0.621
48113013805,51,43,94,0.457,0.543
48113016521,441,484,925,0.523,0.477
48113018505,60,51,111,0.459,0.541
48113014131,242,206,448,0.46,0.54
48113980000,635,412,1047,0.394,0.606
48113007913,101,76,177,0.429,0.571
48113018133,418,464,882,0.526,0.474
48039660200,582,533,1115,0.478,0.522
48113020000,435,605,1040,0.582,0.418
48069950300,4109,1004,5113,0.196,0.804
48069950200,1499,562,2061,0.273,0.727
48069950100,2693,797,3490,0.228,0.772
48071710200,2084,1096,3180,0.345,0.655
48071710300,565,481,1046,0.46,0.54
48071710401,1072,1211,2283,0.53,0.47
48071710500,1358,1036,2394,0.433,0.567
48071710600,51,52,103,0.505,0.495
48071710100,1347,605,1952,0.31,0.69
48081950200,4359,965,5324,0.181,0.819
48081950100,3635,742,4377,0.17,0.83
48091310801,407,550,957,0.575,0.425
48091310703,446,579,1025,0.565,0.435
48355000500,265,344,609,0.565,0.435
48113018135,229,256,485,0.528,0.472
48355002301,249,435,684,0.636,0.364
48355002303,184,296,480,0.617,0.383
48355002304,150,269,419,0.642,0.358
48427950402,1679,1992,3671,0.543,0.457
48427950401,754,954,1708,0.559,0.441
48427950108,1001,989,1990,0.497,0.503
48427950106,190,281,471,0.597,0.403
48427950107,251,365,616,0.593,0.407
48427950104,349,450,799,0.563,0.437
48427950204,536,696,1232,0.565,0.435
48427950105,167,246,413,0.596,0.404
48427950203,127,192,319,0.602,0.398
48099980000,2053,1827,3880,0.471,0.529
48099010202,976,621,1597,0.389,0.611
48099010603,287,376,663,0.567,0.433
48099010604,262,354,616,0.575,0.425
48355002400,462,709,1171,0.605,0.395
48141010214,418,231,649,0.356,0.644
48141010341,3193,1299,4492,0.289,0.711
48141010344,4198,1136,5334,0.213,0.787
48141010319,943,236,1179,0.2,0.8
48141010327,249,165,414,0.399,0.601
48141010505,644,284,928,0.306,0.694
48141010343,663,345,1008,0.342,0.658
48141010502,1014,333,1347,0.247,0.753
48141001111,199,93,292,0.318,0.682
48039660802,280,321,601,0.534,0.466
48039660801,330,338,668,0.506,0.494
48039661502,216,172,388,0.443,0.557
48039661501,423,356,779,0.457,0.543
48121021524,173,196,369,0.531,0.469
48121021741,122,151,273,0.553,0.447
48121021724,203,334,537,0.622,0.378
48121021753,296,449,745,0.603,0.397
48121020104,1271,910,2181,0.417,0.583
48121020108,1183,1047,2230,0.47,0.53
48121020113,641,594,1235,0.481,0.519
48121020105,754,616,1370,0.45,0.55
48355000900,280,384,664,0.578,0.422
48355001000,348,401,749,0.535,0.465
48355001100,336,389,725,0.537,0.463
48121021736,119,138,257,0.537,0.463
48121021406,409,594,1003,0.592,0.408
48121020310,388,415,803,0.517,0.483
48121021748,269,320,589,0.543,0.457
48121021512,559,555,1114,0.498,0.502
48355001200,563,610,1173,0.52,0.48
48355002500,303,575,878,0.655,0.345
48355002703,247,469,716,0.655,0.345
48355005417,202,276,478,0.577,0.423
48355006100,373,727,1100,0.661,0.339
48355005900,725,1250,1975,0.633,0.367
48141010329,221,139,360,0.386,0.614
48185180301,1402,1463,2865,0.511,0.489
48309000900,630,809,1439,0.562,0.438
48309001100,821,964,1785,0.54,0.46
48309000700,662,771,1433,0.538,0.462
48309000800,311,439,750,0.585,0.415
48309001200,351,408,759,0.538,0.462
48003950200,895,569,1464,0.389,0.611
48003950100,3060,1086,4146,0.262,0.738
48003950400,3319,1115,4434,0.251,0.749
48003950300,910,605,1515,0.399,0.601
48309001300,493,597,1090,0.548,0.452
48079950100,5986,1425,7411,0.192,0.808
48355001500,266,356,622,0.572,0.428
48355001300,318,404,722,0.56,0.44
48355001400,443,770,1213,0.635,0.365
48471790600,537,504,1041,0.484,0.516
48471790700,574,513,1087,0.472,0.528
48471790800,488,457,945,0.484,0.516
48381020800,451,201,652,0.308,0.692
48451000200,974,274,1248,0.22,0.78
48451000900,1065,262,1327,0.197,0.803
48451000100,532,156,688,0.227,0.773
48135001100,660,372,1032,0.36,0.64
48135001300,700,539,1239,0.435,0.565
48135001500,927,589,1516,0.389,0.611
48381021000,262,127,389,0.326,0.674
48381021200,401,149,550,0.271,0.729
48381021300,384,165,549,0.301,0.699
48381021500,521,238,759,0.314,0.686
48451001303,488,118,606,0.195,0.805
48451001304,408,100,508,0.197,0.803
48451001500,622,157,779,0.202,0.798
48205950200,4288,1980,6268,0.316,0.684
48355001601,277,346,623,0.555,0.445
48355001602,220,364,584,0.623,0.377
48355001801,308,596,904,0.659,0.341
48355003401,201,341,542,0.629,0.371
48309001400,1004,1158,2162,0.536,0.464
48309001500,1338,1291,2629,0.491,0.509
48149970500,3058,2298,5356,0.429,0.571
48149970200,1182,1446,2628,0.55,0.45
48149970600,2418,1853,4271,0.434,0.566
48149970300,2231,1319,3550,0.372,0.628
48149970700,1130,998,2128,0.469,0.531
48149970100,1423,1067,2490,0.429,0.571
48149970400,1469,1748,3217,0.543,0.457
48395960500,1809,1179,2988,0.395,0.605
48395960300,1437,936,2373,0.394,0.606
48395960400,1209,934,2143,0.436,0.564
48177000600,1248,1368,2616,0.523,0.477
48177000100,1280,1459,2739,0.533,0.467
48121020109,334,312,646,0.483,0.517
48355003402,338,587,925,0.635,0.365
48355003601,226,294,520,0.565,0.435
48395960100,696,652,1348,0.484,0.516
48395960200,834,597,1431,0.417,0.583
48121021526,604,479,1083,0.442,0.558
48355001802,193,343,536,0.64,0.36
48479001300,517,315,832,0.379,0.621
48355003603,257,323,580,0.557,0.443
48355005102,482,506,988,0.512,0.488
48135001600,864,600,1464,0.41,0.59
48135001700,644,492,1136,0.433,0.567
48135001800,486,309,795,0.389,0.611
48135001900,816,444,1260,0.352,0.648
48479001502,447,282,729,0.387,0.613
48479001706,217,159,376,0.423,0.577
48479001709,295,257,552,0.466,0.534
48183000300,504,327,831,0.394,0.606
48183000501,479,309,788,0.392,0.608
48145000400,1160,415,1575,0.263,0.737
48145000700,1132,791,1923,0.411,0.589
48145000200,1318,975,2293,0.425,0.575
48145000500,1043,648,1691,0.383,0.617
48145000300,1068,378,1446,0.261,0.739
48381021603,127,55,182,0.302,0.698
48381021604,245,106,351,0.302,0.698
48381021605,138,51,189,0.27,0.73
48381021606,309,138,447,0.309,0.691
48381021802,683,270,953,0.283,0.717
48159950100,2161,1318,3479,0.379,0.621
48159950200,590,368,958,0.384,0.616
48159950300,1100,579,1679,0.345,0.655
48157670500,366,307,673,0.456,0.544
48157671100,410,295,705,0.418,0.582
48157671200,357,249,606,0.411,0.589
48157671300,265,178,443,0.402,0.598
48093950100,1958,1402,3360,0.417,0.583
48093950200,2344,1171,3515,0.333,0.667
48093950400,1423,839,2262,0.371,0.629
48093950300,2070,566,2636,0.215,0.785
48355001902,301,576,877,0.657,0.343
48469000800,795,634,1429,0.444,0.556
48469000700,807,702,1509,0.465,0.535
48469001400,1102,889,1991,0.447,0.553
48469000502,297,244,541,0.451,0.549
48469001300,1161,1113,2274,0.489,0.511
48469001700,1361,1315,2676,0.491,0.509
48469000100,801,647,1448,0.447,0.553
48449950800,540,344,884,0.389,0.611
48449950100,815,566,1381,0.41,0.59
48449950200,619,563,1182,0.476,0.524
48449950300,961,753,1714,0.439,0.561
48449950400,693,568,1261,0.45,0.55
48449950600,713,433,1146,0.378,0.622
48449950700,408,245,653,0.375,0.625
48449950500,474,317,791,0.401,0.599
48485010800,535,264,799,0.33,0.67
48485010900,313,153,466,0.328,0.672
48485011000,471,225,696,0.323,0.677
48485011100,610,312,922,0.338,0.662
48177000500,1377,1109,2486,0.446,0.554
48177000200,1061,1556,2617,0.595,0.405
48177000400,294,696,990,0.703,0.297
48177000300,354,856,1210,0.707,0.293
48479001101,319,264,583,0.453,0.547
48157671700,407,411,818,0.502,0.498
48157671800,963,576,1539,0.374,0.626
48157671900,241,260,501,0.519,0.481
48157672100,436,444,880,0.505,0.495
48485013100,938,447,1385,0.323,0.677
48135002503,323,196,519,0.378,0.622
48135002700,2268,432,2700,0.16,0.84
48135002801,636,112,748,0.15,0.85
48135002000,457,199,656,0.303,0.697
48135002300,478,223,701,0.318,0.682
48135002400,509,371,880,0.422,0.578
48135002501,400,302,702,0.43,0.57
48485011300,307,165,472,0.35,0.65
48485011400,385,199,584,0.341,0.659
48157672200,204,250,454,0.551,0.449
48157672400,321,343,664,0.517,0.483
48157672500,279,291,570,0.511,0.489
48485011500,327,166,493,0.337,0.663
48485011600,652,344,996,0.345,0.655
48485011800,199,114,313,0.364,0.636
48439106700,316,245,561,0.437,0.563
48439110101,577,560,1137,0.493,0.507
48439110102,363,332,695,0.478,0.522
48439110203,675,592,1267,0.467,0.533
48237950300,1103,846,1949,0.434,0.566
48237950100,3117,3497,6614,0.529,0.471
48135002802,2335,406,2741,0.148,0.852
48135002900,290,224,514,0.436,0.564
48157672800,238,202,440,0.459,0.541
48157672900,1331,1433,2764,0.518,0.482
48099010400,681,410,1091,0.376,0.624
48099010802,245,334,579,0.577,0.423
48099010701,230,341,571,0.597,0.403
48485011900,395,222,617,0.36,0.64
48075950100,3427,1209,4636,0.261,0.739
48101950100,3701,1624,5325,0.305,0.695
48037010901,489,526,1015,0.518,0.482
48157674502,606,1135,1741,0.652,0.348
48157674602,409,353,762,0.463,0.537
48157671502,103,75,178,0.421,0.579
48157674604,207,179,386,0.464,0.536
48157673500,428,365,793,0.46,0.54
48157673600,399,314,713,0.44,0.56
48037010700,344,421,765,0.55,0.45
48037010500,691,751,1442,0.521,0.479
48485012000,626,321,947,0.339,0.661
48485012100,332,156,488,0.32,0.68
48037011401,661,766,1427,0.537,0.463
48037011700,496,490,986,0.497,0.503
48037011402,389,438,827,0.53,0.47
48037010600,345,326,671,0.486,0.514
48037011600,1074,1157,2231,0.519,0.481
48037011100,554,599,1153,0.52,0.48
48037011200,738,809,1547,0.523,0.477
48441012802,245,84,329,0.255,0.745
48073950100,1233,815,2048,0.398,0.602
48073950700,548,369,917,0.402,0.598
48073951000,836,697,1533,0.455,0.545
48073950500,853,539,1392,0.387,0.613
48073950400,492,317,809,0.392,0.608
48073950600,721,457,1178,0.388,0.612
48073950900,848,326,1174,0.278,0.722
48073950200,1106,723,1829,0.395,0.605
48073950300,1615,945,2560,0.369,0.631
48073951100,339,291,630,0.462,0.538
48037010800,289,272,561,0.485,0.515
48037011300,1828,1848,3676,0.503,0.497
48037010100,686,672,1358,0.495,0.505
48029141402,271,302,573,0.527,0.473
48029141600,282,335,617,0.543,0.457
48029141700,843,880,1723,0.511,0.489
48029150100,588,889,1477,0.602,0.398
48037010400,751,785,1536,0.511,0.489
48441012801,246,79,325,0.243,0.757
48029150300,573,716,1289,0.555,0.445
48029150400,351,454,805,0.564,0.436
48029150501,367,467,834,0.56,0.44
48029150502,297,361,658,0.549,0.451
48029150600,355,439,794,0.553,0.447
48029150700,367,455,822,0.554,0.446
48029150800,221,284,505,0.562,0.438
48029150900,417,550,967,0.569,0.431
48029151000,183,214,397,0.539,0.461
48117950400,573,228,801,0.285,0.715
48117950500,1197,490,1687,0.29,0.71
48117950300,546,218,764,0.285,0.715
48037010902,596,657,1253,0.524,0.476
48061012609,158,257,415,0.619,0.381
48061012612,274,397,671,0.592,0.408
48061012607,219,227,446,0.509,0.491
48061012613,226,284,510,0.557,0.443
48037011000,509,507,1016,0.499,0.501
48325000200,1685,2472,4157,0.595,0.405
48325000300,2028,1384,3412,0.406,0.594
48325000500,2451,2211,4662,0.474,0.526
48325000800,2307,1740,4047,0.43,0.57
48027020500,531,316,847,0.373,0.627
48027020701,620,385,1005,0.383,0.617
48027020702,742,473,1215,0.389,0.611
48027020900,346,211,557,0.379,0.621
48027021000,675,438,1113,0.394,0.606
48027021100,545,424,969,0.438,0.562
48493000403,612,445,1057,0.421,0.579
48041000300,687,685,1372,0.499,0.501
48041001302,236,229,465,0.492,0.508
48041002002,770,800,1570,0.51,0.49
48041000500,1323,1373,2696,0.509,0.491
48041001801,374,367,741,0.495,0.505
48061012900,212,263,475,0.554,0.446
48061013002,257,335,592,0.566,0.434
48061013003,126,138,264,0.523,0.477
48061013004,224,246,470,0.523,0.477
48061013102,170,222,392,0.566,0.434
48061013104,106,142,248,0.573,0.427
48061013106,307,339,646,0.525,0.475
48061013204,69,84,153,0.549,0.451
48061013205,99,124,223,0.556,0.444
48215021403,306,692,998,0.693,0.307
48215021904,261,623,884,0.705,0.295
48215021903,271,680,951,0.715,0.285
48215021803,250,567,817,0.694,0.306
48439121605,392,344,736,0.467,0.533
48439121608,479,391,870,0.449,0.551
48439121611,414,323,737,0.438,0.562
48441012900,162,58,220,0.264,0.736
48441011000,849,276,1125,0.245,0.755
48441013600,2847,1203,4050,0.297,0.703
48441010100,594,217,811,0.268,0.732
48441013401,295,102,397,0.257,0.743
48441013200,578,216,794,0.272,0.728
48439121702,597,540,1137,0.475,0.525
48439121703,252,200,452,0.442,0.558
48027020100,1564,983,2547,0.386,0.614
48027021602,231,203,434,0.468,0.532
48027020300,524,571,1095,0.521,0.479
48027020800,660,415,1075,0.386,0.614
48027021400,484,395,879,0.449,0.551
48027020600,512,331,843,0.393,0.607
48027021302,323,242,565,0.428,0.572
48027023402,1133,925,2058,0.449,0.551
48027022801,244,235,479,0.491,0.509
48027023300,723,815,1538,0.53,0.47
48027022402,199,312,511,0.611,0.389
48027021800,922,1143,2065,0.554,0.446
48027021203,561,451,1012,0.446,0.554
48027021500,721,598,1319,0.453,0.547
48027021303,457,440,897,0.491,0.509
48027022000,502,596,1098,0.543,0.457
48027021601,943,712,1655,0.43,0.57
48027021700,631,551,1182,0.466,0.534
48441010200,579,204,783,0.261,0.739
48441010300,217,87,304,0.286,0.714
48441010400,413,154,567,0.272,0.728
48441010500,222,88,310,0.284,0.716
48441010600,402,144,546,0.264,0.736
48441010700,455,152,607,0.25,0.75
48441010800,630,210,840,0.25,0.75
48441010900,868,298,1166,0.256,0.744
48441011200,600,202,802,0.252,0.748
48441011300,426,146,572,0.255,0.745
48041000400,700,696,1396,0.499,0.501
48041000603,1037,1052,2089,0.504,0.496
48041000604,433,471,904,0.521,0.479
48041000700,617,624,1241,0.503,0.497
48041000800,674,685,1359,0.504,0.496
48439103601,399,261,660,0.395,0.605
48439114102,864,667,1531,0.436,0.564
48439110401,1190,833,2023,0.412,0.588
48439113404,655,571,1226,0.466,0.534
48441011400,660,237,897,0.264,0.736
48041000900,516,529,1045,0.506,0.494
48041001000,648,623,1271,0.49,0.51
48041001100,369,362,731,0.495,0.505
48061013207,208,259,467,0.555,0.445
48113013616,836,430,1266,0.34,0.66
48061013303,75,106,181,0.586,0.414
48061013305,112,172,284,0.606,0.394
48061013307,90,135,225,0.6,0.4
48061013206,117,140,257,0.545,0.455
48441011500,648,220,868,0.253,0.747
48441011600,666,230,896,0.257,0.743
48441011900,516,168,684,0.246,0.754
48441012000,420,165,585,0.282,0.718
48441012100,132,41,173,0.237,0.763
48441012200,675,225,900,0.25,0.75
48441012300,692,239,931,0.257,0.743
48441012400,494,164,658,0.249,0.751
48453001856,769,672,1441,0.466,0.534
48061013308,115,125,240,0.521,0.479
48061013401,269,324,593,0.546,0.454
48439122100,694,698,1392,0.501,0.499
48481740600,1167,1048,2215,0.473,0.527
48263950100,3353,1140,4493,0.254,0.746
48481740700,1572,1095,2667,0.411,0.589
48481740200,555,402,957,0.42,0.58
48481740100,2217,1528,3745,0.408,0.592
48481740400,1198,905,2103,0.43,0.57
48481740900,1656,1073,2729,0.393,0.607
48441012500,376,124,500,0.248,0.752
48441012600,344,112,456,0.246,0.754
48441012700,662,295,957,0.308,0.692
48441013000,435,169,604,0.28,0.72
48215021804,313,588,901,0.653,0.347
48215022401,342,1129,1471,0.768,0.232
48215024114,204,291,495,0.588,0.412
48441013100,944,367,1311,0.28,0.72
48113019018,189,174,363,0.479,0.521
48215023904,219,492,711,0.692,0.308
48215024113,271,428,699,0.612,0.388
48215024203,416,1017,1433,0.71,0.29
48181001400,1071,819,1890,0.433,0.567
48181001500,863,689,1552,0.444,0.556
48181000302,1532,1671,3203,0.522,0.478
48181000502,518,421,939,0.448,0.552
48181000501,732,599,1331,0.45,0.55
48181001101,1252,1191,2443,0.488,0.512
48181000101,1130,953,2083,0.458,0.542
48181000901,927,959,1886,0.508,0.492
48181000400,409,378,787,0.48,0.52
48181001900,2978,2887,5865,0.492,0.508
48181001803,1713,1494,3207,0.466,0.534
48181001802,1136,927,2063,0.449,0.551
48181000600,541,481,1022,0.471,0.529
48181001700,695,520,1215,0.428,0.572
48181001102,1912,1590,3502,0.454,0.546
48181000902,1686,1173,2859,0.41,0.59
48181000102,852,657,1509,0.435,0.565
48181000800,715,659,1374,0.48,0.52
48215020725,216,374,590,0.634,0.366
48215021805,211,611,822,0.743,0.257
48215022003,434,1090,1524,0.715,0.285
48215022105,383,700,1083,0.646,0.354
48215022203,397,820,1217,0.674,0.326
48491020703,765,669,1434,0.467,0.533
48491020704,226,160,386,0.415,0.585
48491021100,706,476,1182,0.403,0.597
48491021201,343,287,630,0.456,0.544
48491021202,482,395,877,0.45,0.55
48491021203,432,318,750,0.424,0.576
48001950401,81,78,159,0.491,0.509
48001950902,745,699,1444,0.484,0.516
48001950402,136,167,303,0.551,0.449
48411950200,3240,2579,5819,0.443,0.557
48411950100,866,954,1820,0.524,0.476
48181000700,823,663,1486,0.446,0.554
48181001200,666,530,1196,0.443,0.557
48181001300,480,373,853,0.437,0.563
48097001100,1189,904,2093,0.432,0.568
48181001801,1217,1065,2282,0.467,0.533
48491020701,601,448,1049,0.427,0.573
48215024107,63,166,229,0.725,0.275
48215023903,323,557,880,0.633,0.367
48215024403,546,863,1409,0.612,0.388
48491021402,1233,601,1834,0.328,0.672
48491021403,898,443,1341,0.33,0.67
48491021503,330,214,544,0.393,0.607
48221160205,1804,1306,3110,0.42,0.58
48221160302,2248,1723,3971,0.434,0.566
48221160209,1390,987,2377,0.415,0.585
48439122700,469,403,872,0.462,0.538
48439104503,509,347,856,0.405,0.595
48439110202,417,359,776,0.463,0.537
48113015700,254,208,462,0.45,0.55
48113016001,386,380,766,0.496,0.504
48113016002,236,225,461,0.488,0.512
48113016100,452,421,873,0.482,0.518
48113016201,215,252,467,0.54,0.46
48257051300,1945,1470,3415,0.43,0.57
48257050600,1851,978,2829,0.346,0.654
48257050701,1224,580,1804,0.322,0.678
48257050300,751,372,1123,0.331,0.669
48257050500,1580,781,2361,0.331,0.669
48257051000,540,337,877,0.384,0.616
48257050400,1105,480,1585,0.303,0.697
48257050201,908,570,1478,0.386,0.614
48257050800,2130,1069,3199,0.334,0.666
48257051100,1189,669,1858,0.36,0.64
48459950100,1088,1213,2301,0.527,0.473
48459950200,683,755,1438,0.525,0.475
48459950400,1275,756,2031,0.372,0.628
48459950600,694,486,1180,0.412,0.588
48459950300,1195,1165,2360,0.494,0.506
48459950500,1691,967,2658,0.364,0.636
48459950700,742,610,1352,0.451,0.549
48061013306,100,128,228,0.561,0.439
48061012505,465,749,1214,0.617,0.383
48061012608,136,185,321,0.576,0.424
48061012800,249,358,607,0.59,0.41
48061010401,252,722,974,0.741,0.259
48113016301,454,490,944,0.519,0.481
48453002112,167,268,435,0.616,0.384
48453002113,180,316,496,0.637,0.363
48453002201,204,318,522,0.609,0.391
48167722900,214,208,422,0.493,0.507
48167723100,212,211,423,0.499,0.501
48167723200,441,393,834,0.471,0.529
48167723300,577,436,1013,0.43,0.57
48167723000,270,235,505,0.465,0.535
48167721500,607,590,1197,0.493,0.507
48135000300,241,177,418,0.423,0.577
48135000600,362,283,645,0.439,0.561
48135000700,342,277,619,0.447,0.553
48135000100,403,225,628,0.358,0.642
48113016401,584,617,1201,0.514,0.486
48113016408,453,475,928,0.512,0.488
48113016410,310,321,631,0.509,0.491
48113016411,536,516,1052,0.49,0.51
48113016502,778,729,1507,0.484,0.516
48113016302,80,85,165,0.515,0.485
48113016509,622,615,1237,0.497,0.503
48453002202,342,386,728,0.53,0.47
48453980000,148,174,322,0.54,0.46
48453002304,59,103,162,0.636,0.364
48453002308,193,215,408,0.527,0.473
48453002312,274,382,656,0.582,0.418
48453002314,100,133,233,0.571,0.429
48453002316,68,83,151,0.55,0.45
48135000400,406,322,728,0.442,0.558
48249950100,1661,3641,5302,0.687,0.313
48249950300,575,759,1334,0.569,0.431
48249950700,1348,3720,5068,0.734,0.266
48249950200,1957,2942,4899,0.601,0.399
48249950400,590,674,1264,0.533,0.467
48249950500,707,811,1518,0.534,0.466
48249950600,657,902,1559,0.579,0.421
48031950100,2120,1582,3702,0.427,0.573
48033950100,4071,1113,5184,0.215,0.785
48035950500,1074,769,1843,0.417,0.583
48465950500,2153,921,3074,0.3,0.7
48465950601,523,385,908,0.424,0.576
48465950201,1058,608,1666,0.365,0.635
48465950400,778,559,1337,0.418,0.582
48031950200,2028,1315,3343,0.393,0.607
48113016510,836,844,1680,0.502,0.498
48113016511,411,368,779,0.472,0.528
48465950602,934,646,1580,0.409,0.591
48465950700,1072,712,1784,0.399,0.601
48167720800,690,495,1185,0.418,0.582
48167726000,265,315,580,0.543,0.457
48167721900,881,750,1631,0.46,0.54
48167722800,297,261,558,0.468,0.532
48167723400,669,483,1152,0.419,0.581
48167721600,306,223,529,0.422,0.578
48167720600,596,619,1215,0.509,0.491
48167723800,634,675,1309,0.516,0.484
48113016615,464,397,861,0.461,0.539
48113016616,502,411,913,0.45,0.55
48113018111,444,664,1108,0.599,0.401
48167726100,921,996,1917,0.52,0.48
48167720100,243,243,486,0.5,0.5
48167724900,365,282,647,0.436,0.564
48167720200,236,238,474,0.502,0.498
48167722200,1002,587,1589,0.369,0.631
48167723600,812,659,1471,0.448,0.552
48167723900,1635,1014,2649,0.383,0.617
48167725700,196,128,324,0.395,0.605
48167721800,868,525,1393,0.377,0.623
48167724200,183,129,312,0.413,0.587
48453002403,212,262,474,0.553,0.447
48453002409,129,199,328,0.607,0.393
48453002410,106,153,259,0.591,0.409
48453002411,240,340,580,0.586,0.414
48453002412,182,360,542,0.664,0.336
48453002413,88,170,258,0.659,0.341
48453002419,47,71,118,0.602,0.398
48323950201,2327,780,3107,0.251,0.749
48323950500,698,283,981,0.288,0.712
48323950400,341,139,480,0.29,0.71
48323950602,428,178,606,0.294,0.706
48323950300,452,198,650,0.305,0.695
48323950601,324,130,454,0.286,0.714
48095950300,6064,1278,7342,0.174,0.826
48409010602,162,248,410,0.605,0.395
48409010604,204,337,541,0.623,0.377
48409010800,406,681,1087,0.626,0.374
48143950700,1733,1421,3154,0.451,0.549
48143950300,2957,1863,4820,0.387,0.613
48143950500,1349,783,2132,0.367,0.633
48143950600,915,516,1431,0.361,0.639
48143950400,912,499,1411,0.354,0.646
48143950100,3492,2330,5822,0.4,0.6
48453002422,260,404,664,0.608,0.392
48453002423,202,307,509,0.603,0.397
48453002424,131,201,332,0.605,0.395
48453001742,588,657,1245,0.528,0.472
48453001760,543,659,1202,0.548,0.452
48453001826,202,217,419,0.518,0.482
48453002310,235,353,588,0.6,0.4
48491020302,481,273,754,0.362,0.638
48491020301,1359,676,2035,0.332,0.668
48491020310,346,237,583,0.407,0.593
48491020900,1889,1289,3178,0.406,0.594
48491021300,1828,831,2659,0.313,0.687
48491021502,220,163,383,0.426,0.574
48491021000,872,607,1479,0.41,0.59
48491021401,1148,560,1708,0.328,0.672
48061011902,382,1227,1609,0.763,0.237
48061012301,755,1038,1793,0.579,0.421
48061010100,1380,2069,3449,0.6,0.4
48061012700,615,739,1354,0.546,0.454
48061013203,105,104,209,0.498,0.502
48061012508,162,279,441,0.633,0.367
48061011903,261,604,865,0.698,0.302
48061014002,270,273,543,0.503,0.497
48061011400,711,996,1707,0.583,0.417
48061012401,449,689,1138,0.605,0.395
48061011600,755,822,1577,0.521,0.479
